hour,date,plaza,count,revenue,passCount,passRevenue,cashCount,cashRevenue
0,11,HLC,1373,11790.56,1174,9939.06,199,1851.50
1,11,HLC,1051,8970.29,885,7479.29,166,1491.00
2,11,HLC,466,3977.50,388,3246.50,78,731.00
3,11,HLC,301,2583.78,254,2150.28,47,433.50
4,11,HLC,245,2185.00,193,1659.50,52,525.50
5,11,HLC,281,2524.04,238,2004.54,43,519.50
6,11,HLC,501,4266.33,446,3651.83,55,614.50
7,11,HLC,766,6712.59,650,5464.59,116,1248.00
8,11,HLC,1235,10678.47,1062,8989.97,173,1688.50
9,11,HLC,1794,15694.58,1552,13238.08,242,2456.50
10,11,HLC,2403,20810.86,2060,17655.86,343,3155.00
11,11,HLC,3026,26103.92,2603,22143.92,423,3960.00
12,11,HLC,3028,25982.38,2618,22212.38,410,3770.00
13,11,HLC,3309,28323.88,2805,23736.88,504,4587.00
14,11,HLC,3370,28812.25,2873,24280.25,497,4532.00
15,11,HLC,3513,30136.26,2993,25439.26,520,4697.00
16,11,HLC,3825,32663.51,3294,27857.01,531,4806.50
17,11,HLC,4157,35620.84,3590,30432.34,567,5188.50
18,11,HLC,3900,33163.81,3354,28395.81,546,4768.00
19,11,HLC,3014,25785.57,2538,21235.57,476,4550.00
20,11,HLC,3154,26930.70,2725,23124.20,429,3806.50
21,11,HLC,2678,22781.32,2324,19686.82,354,3094.50
22,11,HLC,2152,18340.52,1832,15421.02,320,2919.50
23,11,HLC,960,8211.81,823,6919.81,137,1292.00
0,12,HLC,504,4361.73,422,3571.23,82,790.50
1,12,HLC,184,1594.29,155,1285.79,29,308.50
2,12,HLC,104,973.26,89,792.26,15,181.00
3,12,HLC,102,1109.78,68,627.78,34,482.00
4,12,HLC,172,1640.83,141,1253.33,31,387.50
5,12,HLC,799,7408.03,675,5703.03,124,1705.00
6,12,HLC,2808,25326.10,2403,20527.60,405,4798.50
7,12,HLC,3420,31398.79,2881,24766.29,539,6632.50
8,12,HLC,3682,33697.91,3134,26879.41,548,6818.50
9,12,HLC,3558,32487.34,3024,26121.84,534,6365.50
10,12,HLC,2741,25269.53,2287,19988.53,454,5281.00
11,12,HLC,2600,23830.12,2160,18727.12,440,5103.00
12,12,HLC,2654,24137.56,2220,19263.06,434,4874.50
13,12,HLC,2820,25587.33,2335,20168.83,485,5418.50
14,12,HLC,3244,29106.84,2719,23404.84,525,5702.00
15,12,HLC,3541,31698.52,3007,25738.02,534,5960.50
16,12,HLC,3682,32537.41,3197,27284.41,485,5253.00
17,12,HLC,3892,34294.93,3388,28957.93,504,5337.00
18,12,HLC,3687,32197.82,3218,27293.82,469,4904.00
19,12,HLC,2867,24755.02,2480,20900.02,387,3855.00
20,12,HLC,2014,17320.91,1746,14728.41,268,2592.50
21,12,HLC,1588,13583.50,1365,11501.50,223,2082.00
22,12,HLC,1371,11829.83,1185,10039.83,186,1790.00
23,12,HLC,789,6770.11,684,5747.61,105,1022.50
0,13,HLC,404,3486.60,348,2886.60,56,600.00
1,13,HLC,180,1500.54,147,1203.04,33,297.50
2,13,HLC,110,1004.52,94,798.02,16,206.50
3,13,HLC,102,931.32,83,716.32,19,215.00
4,13,HLC,223,2165.57,187,1710.07,36,455.50
5,13,HLC,1166,10714.41,984,8389.91,182,2324.50
6,13,HLC,3412,30545.84,2887,24424.84,525,6121.00
7,13,HLC,3923,35533.74,3333,28462.74,590,7071.00
8,13,HLC,3785,34603.61,3198,27288.11,587,7315.50
9,13,HLC,3536,32292.13,3028,26030.13,508,6262.00
10,13,HLC,3500,31954.34,2936,25316.84,564,6637.50
11,13,HLC,2714,24866.02,2226,19164.02,488,5702.00
12,13,HLC,2860,26022.75,2368,20394.75,492,5628.00
13,13,HLC,3014,27139.57,2538,21744.07,476,5395.50
14,13,HLC,3547,31846.74,2967,25286.24,580,6560.50
15,13,HLC,4161,37397.16,3477,29603.66,684,7793.50
16,13,HLC,4072,36306.76,3463,29559.76,609,6747.00
17,13,HLC,3971,35283.21,3449,29298.71,522,5984.50
18,13,HLC,4133,35925.90,3640,30721.90,493,5204.00
19,13,HLC,3503,30185.68,3092,26110.68,411,4075.00
20,13,HLC,2425,21055.96,2101,17698.46,324,3357.50
21,13,HLC,1807,15774.13,1575,13314.13,232,2460.00
22,13,HLC,1498,13245.66,1323,11333.16,175,1912.50
23,13,HLC,937,8354.60,825,7116.60,112,1238.00
0,14,HLC,641,5927.81,558,4899.31,83,1028.50
1,14,HLC,220,2151.82,187,1721.32,33,430.50
2,14,HLC,149,1560.08,117,1083.08,32,477.00
3,14,HLC,85,822.76,69,607.76,16,215.00
4,14,HLC,214,2217.56,162,1479.56,52,738.00
5,14,HLC,1082,10063.54,928,7894.04,154,2169.50
6,14,HLC,3532,31998.96,2991,25480.46,541,6518.50
7,14,HLC,4254,38714.72,3641,31094.22,613,7620.50
8,14,HLC,3986,36654.20,3389,29018.70,597,7635.50
9,14,HLC,3720,33739.07,3127,26623.07,593,7116.00
10,14,HLC,2946,26779.97,2476,21273.97,470,5506.00
11,14,HLC,2769,24754.59,2335,19879.59,434,4875.00
12,14,HLC,3003,27429.23,2472,21345.23,531,6084.00
13,14,HLC,2902,26401.11,2451,21315.11,451,5086.00
14,14,HLC,3399,30465.92,2859,24375.42,540,6090.50
15,14,HLC,3829,34350.90,3247,27619.90,582,6731.00
16,14,HLC,4197,37636.88,3614,31044.88,583,6592.00
17,14,HLC,4067,35995.47,3543,30173.97,524,5821.50
18,14,HLC,4121,35894.19,3647,30946.69,474,4947.50
19,14,HLC,3714,32073.17,3208,27008.17,506,5065.00
20,14,HLC,2151,18812.94,1851,15658.94,300,3154.00
21,14,HLC,2067,17840.37,1804,15262.87,263,2577.50
22,14,HLC,1841,15824.67,1592,13347.67,249,2477.00
23,14,HLC,1363,12308.54,1164,10043.54,199,2265.00
0,15,HLC,641,5839.34,566,4865.84,75,973.50
1,15,HLC,250,2783.07,204,2020.57,46,762.50
2,15,HLC,156,2113.53,121,1387.03,35,726.50
3,15,HLC,166,2477.03,114,1415.03,52,1062.00
4,15,HLC,255,3407.78,188,2129.28,67,1278.50
5,15,HLC,1065,10795.94,880,7825.44,185,2970.50
6,15,HLC,3350,30878.86,2828,24197.86,522,6681.00
7,15,HLC,4139,38992.07,3483,30112.57,656,8879.50
8,15,HLC,4174,38770.99,3537,30419.99,637,8351.00
9,15,HLC,3660,34009.16,3076,26577.66,584,7431.50
10,15,HLC,2983,27298.92,2494,21526.42,489,5772.50
11,15,HLC,2891,26797.37,2406,20878.87,485,5918.50
12,15,HLC,2691,24561.17,2262,19544.67,429,5016.50
13,15,HLC,2935,26620.27,2502,21581.27,433,5039.00
14,15,HLC,3397,30701.71,2831,24138.21,566,6563.50
15,15,HLC,2970,26679.87,2488,21283.87,482,5396.00
16,15,HLC,2642,23645.50,2219,18828.00,423,4817.50
17,15,HLC,2404,21428.02,2049,17524.52,355,3903.50
18,15,HLC,2464,22132.62,2115,18105.12,349,4027.50
19,15,HLC,2646,23358.25,2295,19397.25,351,3961.00
20,15,HLC,2896,25241.18,2533,21445.68,363,3795.50
21,15,HLC,2206,19160.45,1915,16248.95,291,2911.50
22,15,HLC,1456,12794.39,1243,10529.89,213,2264.50
23,15,HLC,1170,10099.37,1018,8548.37,152,1551.00
0,16,HLC,814,7216.34,720,6174.34,94,1042.00
1,16,HLC,371,3216.60,327,2718.60,44,498.00
2,16,HLC,204,1848.27,168,1448.77,36,399.50
3,16,HLC,180,1757.05,150,1350.05,30,407.00
4,16,HLC,220,2092.28,185,1662.28,35,430.00
5,16,HLC,952,8826.56,819,7015.56,133,1811.00
6,16,HLC,2910,26446.93,2459,20889.93,451,5557.00
7,16,HLC,3472,32370.35,2934,25481.85,538,6888.50
8,16,HLC,3756,34737.49,3138,26755.99,618,7981.50
9,16,HLC,3346,30466.48,2838,24172.48,508,6294.00
10,16,HLC,2702,24581.51,2267,19388.01,435,5193.50
11,16,HLC,2612,23539.22,2199,18965.72,413,4573.50
12,16,HLC,2738,24719.51,2285,19575.01,453,5144.50
13,16,HLC,3083,27979.39,2594,22361.89,489,5617.50
14,16,HLC,3422,30486.16,2899,24686.16,523,5800.00
15,16,HLC,4040,36288.13,3366,28669.63,674,7618.50
16,16,HLC,3757,33639.25,3200,27488.75,557,6150.50
17,16,HLC,3426,30357.63,2962,25161.63,464,5196.00
18,16,HLC,3062,26763.30,2676,22708.80,386,4054.50
19,16,HLC,2678,23389.64,2285,19399.64,393,3990.00
20,16,HLC,2068,17991.66,1777,15134.16,291,2857.50
21,16,HLC,1758,15479.39,1493,12727.89,265,2751.50
22,16,HLC,1727,15028.66,1475,12505.66,252,2523.00
23,16,HLC,1619,14367.80,1406,12012.80,213,2355.00
0,17,HLC,1207,10808.82,1009,8778.32,198,2030.50
1,17,HLC,659,5953.10,554,4792.60,105,1160.50
2,17,HLC,358,3334.05,282,2591.05,76,743.00
3,17,HLC,286,2632.01,223,1947.01,63,685.00
4,17,HLC,237,2306.76,192,1765.26,45,541.50
5,17,HLC,453,4240.64,361,3166.64,92,1074.00
6,17,HLC,1038,9276.86,861,7281.86,177,1995.00
7,17,HLC,1422,12684.35,1200,10174.85,222,2509.50
8,17,HLC,2009,17578.86,1738,14899.86,271,2679.00
9,17,HLC,2524,22084.58,2159,18375.58,365,3709.00
10,17,HLC,2198,19464.82,1858,15869.32,340,3595.50
11,17,HLC,2528,22137.65,2168,18555.65,360,3582.00
12,17,HLC,2767,24293.63,2376,20350.63,391,3943.00
13,17,HLC,2850,24876.44,2410,20509.94,440,4366.50
14,17,HLC,3067,26813.73,2591,22178.73,476,4635.00
15,17,HLC,3240,28061.24,2775,23516.74,465,4544.50
16,17,HLC,3813,32618.58,3275,27687.08,538,4931.50
17,17,HLC,3939,33652.07,3419,28961.57,520,4690.50
18,17,HLC,3697,31629.57,3195,27079.57,502,4550.00
19,17,HLC,3520,30116.33,3049,25775.33,471,4341.00
20,17,HLC,2966,25341.34,2551,21613.84,415,3727.50
21,17,HLC,2782,23865.63,2373,20188.63,409,3677.00
22,17,HLC,2703,23025.56,2354,19956.06,349,3069.50
23,17,HLC,2437,20812.58,2157,18264.08,280,2548.50
0,18,HLC,1758,14301.08,1421,11337.08,337,2964.00
1,18,HLC,740,6341.09,643,5457.09,97,884.00
2,18,HLC,474,4039.22,391,3229.22,83,810.00
3,18,HLC,274,2343.52,229,1915.02,45,428.50
4,18,HLC,234,2031.03,192,1606.03,42,425.00
5,18,HLC,270,2373.53,215,1792.53,55,581.00
6,18,HLC,469,3901.84,403,3220.84,66,681.00
7,18,HLC,776,6693.10,661,5475.10,115,1218.00
8,18,HLC,1147,10009.32,1005,8531.82,142,1477.50
9,18,HLC,1658,14438.55,1461,12455.55,197,1983.00
10,18,HLC,2380,20509.01,2063,17520.51,317,2988.50
11,18,HLC,2686,23127.76,2335,19848.76,351,3279.00
12,18,HLC,3012,25860.08,2608,22132.58,404,3727.50
13,18,HLC,3090,26600.81,2653,22529.31,437,4071.50
14,18,HLC,3332,28565.27,2852,24116.27,480,4449.00
15,18,HLC,3527,30153.67,3013,25447.67,514,4706.00
16,18,HLC,3892,33325.44,3337,28302.94,555,5022.50
17,18,HLC,3833,32896.75,3308,28065.25,525,4831.50
18,18,HLC,3237,27277.88,2736,22595.38,501,4682.50
19,18,HLC,3067,26147.32,2674,22504.32,393,3643.00
20,18,HLC,2410,20597.09,2051,17365.09,359,3232.00
21,18,HLC,1789,15203.63,1509,12678.13,280,2525.50
22,18,HLC,1384,11825.53,1182,10021.53,202,1804.00
23,18,HLC,905,7767.56,788,6677.06,117,1090.50
0,19,HLC,482,4168.31,413,3496.81,69,671.50
1,19,HLC,148,1276.44,126,1061.44,22,215.00
2,19,HLC,126,1154.78,100,767.28,26,387.50
3,19,HLC,91,928.06,71,640.06,20,288.00
4,19,HLC,216,2223.58,173,1594.58,43,629.00
5,19,HLC,1088,10421.46,905,7957.46,183,2464.00
6,19,HLC,3390,30902.39,2858,24274.89,532,6627.50
7,19,HLC,3834,35308.95,3222,27766.45,612,7542.50
8,19,HLC,3787,34464.74,3213,27279.24,574,7185.50
9,19,HLC,3532,31840.07,2998,25512.57,534,6327.50
10,19,HLC,3108,28134.45,2593,22339.95,515,5794.50
11,19,HLC,2865,25967.59,2383,20612.09,482,5355.50
12,19,HLC,2853,25768.30,2359,20377.80,494,5390.50
13,19,HLC,2947,26512.42,2433,20911.92,514,5600.50
14,19,HLC,3542,31785.91,2926,24991.41,616,6794.50
15,19,HLC,3903,35481.68,3216,27419.18,687,8062.50
16,19,HLC,4027,35800.20,3429,29213.20,598,6587.00
17,19,HLC,3793,33564.07,3267,27621.57,526,5942.50
18,19,HLC,3827,33423.66,3337,28148.66,490,5275.00
19,19,HLC,3550,30819.68,3110,26254.18,440,4565.50
20,19,HLC,2641,23034.19,2308,19485.19,333,3549.00
21,19,HLC,1872,16145.79,1647,13926.29,225,2219.50
22,19,HLC,1478,12808.69,1300,11009.69,178,1799.00
23,19,HLC,926,7905.60,806,6716.10,120,1189.50
0,20,HLC,541,4900.56,466,4064.56,75,836.00
1,20,HLC,196,1805.41,159,1378.41,37,427.00
2,20,HLC,97,946.00,77,693.50,20,252.50
3,20,HLC,118,1281.04,98,959.04,20,322.00
4,20,HLC,221,2261.54,176,1642.04,45,619.50
5,20,HLC,1064,9837.65,913,7890.65,151,1947.00
6,20,HLC,3273,29630.96,2784,23610.96,489,6020.00
7,20,HLC,4299,39468.99,3639,31149.49,660,8319.50
8,20,HLC,4319,39616.07,3627,30979.57,692,8636.50
9,20,HLC,3759,34119.23,3196,27247.73,563,6871.50
10,20,HLC,3004,27383.64,2490,21465.14,514,5918.50
11,20,HLC,2951,26603.32,2475,21135.32,476,5468.00
12,20,HLC,2988,27062.36,2479,21319.86,509,5742.50
13,20,HLC,3443,30895.92,2873,24552.92,570,6343.00
14,20,HLC,3618,32599.35,3045,25995.85,573,6603.50
15,20,HLC,4094,36310.79,3468,29338.29,626,6972.50
16,20,HLC,4283,38090.20,3650,31009.20,633,7081.00
17,20,HLC,4025,35667.38,3468,29429.88,557,6237.50
18,20,HLC,3898,34226.30,3427,29228.80,471,4997.50
19,20,HLC,4020,34771.68,3488,29393.68,532,5378.00
20,20,HLC,3349,28957.93,2908,24647.43,441,4310.50
21,20,HLC,2043,17594.81,1781,15054.81,262,2540.00
22,20,HLC,1912,16641.10,1668,14232.60,244,2408.50
23,20,HLC,1283,11306.01,1098,9325.51,185,1980.50
0,21,HLC,808,7093.81,702,6078.81,106,1015.00
1,21,HLC,292,2678.58,243,2136.08,49,542.50
2,21,HLC,131,1269.78,107,969.78,24,300.00
3,21,HLC,96,925.29,73,661.79,23,263.50
4,21,HLC,209,2199.08,163,1513.58,46,685.50
5,21,HLC,965,9025.34,806,6912.34,159,2113.00
6,21,HLC,3236,29563.95,2698,22991.45,538,6572.50
7,21,HLC,4010,36794.64,3367,28846.64,643,7948.00
8,21,HLC,3944,35917.28,3282,28082.28,662,7835.00
9,21,HLC,4117,37695.81,3436,29469.31,681,8226.50
10,21,HLC,3679,33066.49,3057,26375.99,622,6690.50
11,21,HLC,3536,31960.69,2928,25233.69,608,6727.00
12,21,HLC,1963,17996.24,1575,13449.24,388,4547.00
13,21,HLC,2320,21274.77,1873,16015.77,447,5259.00
14,21,HLC,3852,34988.31,3210,27705.81,642,7282.50
15,21,HLC,4150,37026.57,3438,29154.57,712,7872.00
16,21,HLC,4089,36611.57,3455,29526.07,634,7085.50
17,21,HLC,3893,34539.18,3311,28265.68,582,6273.50
18,21,HLC,3323,29008.84,2861,24233.34,462,4775.50
19,21,HLC,2809,24509.69,2370,20057.19,439,4452.50
20,21,HLC,2272,19753.90,1969,16674.90,303,3079.00
21,21,HLC,1906,16284.12,1604,13463.62,302,2820.50
22,21,HLC,1909,16445.65,1613,13587.65,296,2858.00
23,21,HLC,1203,10381.15,1027,8751.15,176,1630.00
0,22,HLC,648,5604.47,538,4569.97,110,1034.50
1,22,HLC,338,3010.07,282,2409.57,56,600.50
2,22,HLC,242,2175.18,190,1634.68,52,540.50
3,22,HLC,226,1945.84,184,1526.84,42,419.00
4,22,HLC,285,2406.27,233,1859.77,52,546.50
5,22,HLC,375,3228.68,328,2660.18,47,568.50
6,22,HLC,608,5154.07,533,4283.07,75,871.00
7,22,HLC,752,6338.43,649,5306.93,103,1031.50
8,22,HLC,814,7101.24,698,5863.74,116,1237.50
9,22,HLC,941,8201.10,807,6858.10,134,1343.00
10,22,HLC,1346,11543.82,1133,9537.82,213,2006.00
11,22,HLC,2122,18069.31,1857,15571.81,265,2497.50
12,22,HLC,3022,25836.29,2587,21670.79,435,4165.50
13,22,HLC,3301,28186.82,2877,24318.32,424,3868.50
14,22,HLC,3421,28951.32,2962,24909.32,459,4042.00
15,22,HLC,3171,26961.91,2708,22812.91,463,4149.00
16,22,HLC,2540,21705.69,2113,17892.69,427,3813.00
17,22,HLC,2093,17940.21,1740,14730.71,353,3209.50
18,22,HLC,1904,16262.26,1588,13401.26,316,2861.00
19,22,HLC,2226,19007.26,1931,16366.26,295,2641.00
20,22,HLC,2594,22122.58,2273,19306.08,321,2816.50
21,22,HLC,2756,23562.22,2415,20493.72,341,3068.50
22,22,HLC,2560,21824.09,2188,18557.59,372,3266.50
23,22,HLC,1951,16646.82,1627,13765.32,324,2881.50
0,23,HLC,689,5922.30,567,4799.30,122,1123.00
1,23,HLC,261,2305.78,218,1872.28,43,433.50
2,23,HLC,154,1349.65,120,1007.15,34,342.50
3,23,HLC,94,966.50,74,704.00,20,262.50
4,23,HLC,118,1050.00,92,713.50,26,336.50
5,23,HLC,425,3868.49,356,3012.99,69,855.50
6,23,HLC,1237,11181.31,1064,8995.31,173,2186.00
7,23,HLC,1504,14190.50,1264,10940.50,240,3250.00
8,23,HLC,1715,15816.19,1443,12307.19,272,3509.00
9,23,HLC,1823,16620.26,1531,13102.26,292,3518.00
10,23,HLC,1812,16108.76,1508,12842.76,304,3266.00
11,23,HLC,1953,17395.65,1620,13870.15,333,3525.50
12,23,HLC,2300,20165.97,1940,16470.97,360,3695.00
13,23,HLC,2793,24726.91,2375,20423.41,418,4303.50
14,23,HLC,2925,25689.75,2461,20862.25,464,4827.50
15,23,HLC,2916,25396.37,2448,20601.87,468,4794.50
16,23,HLC,2787,24308.66,2339,19755.66,448,4553.00
17,23,HLC,2451,21345.65,2064,17496.65,387,3849.00
18,23,HLC,2196,18968.17,1880,15886.17,316,3082.00
19,23,HLC,1634,14099.85,1334,11222.85,300,2877.00
20,23,HLC,1448,12469.30,1198,10089.30,250,2380.00
21,23,HLC,1165,10088.56,946,7991.56,219,2097.00
22,23,HLC,1232,10489.86,1051,8828.86,181,1661.00
23,23,HLC,948,8125.85,796,6693.35,152,1432.50
0,24,HLC,509,4456.31,427,3679.31,82,777.00
1,24,HLC,301,2729.19,227,1973.69,74,755.50
2,24,HLC,199,1769.26,154,1294.26,45,475.00
3,24,HLC,149,1347.26,128,1134.76,21,212.50
4,24,HLC,157,1411.01,132,1130.51,25,280.50
5,24,HLC,244,2155.30,214,1786.30,30,369.00
6,24,HLC,549,4789.54,462,3802.04,87,987.50
7,24,HLC,702,6280.06,584,4955.06,118,1325.00
8,24,HLC,1059,9495.85,895,7743.35,164,1752.50
9,24,HLC,1287,11484.28,1088,9345.28,199,2139.00
10,24,HLC,1508,13470.29,1275,11116.79,233,2353.50
11,24,HLC,1857,16445.94,1586,13676.94,271,2769.00
12,24,HLC,2114,18518.47,1798,15405.97,316,3112.50
13,24,HLC,2125,18474.05,1775,15142.05,350,3332.00
14,24,HLC,2347,20099.07,1959,16565.07,388,3534.00
15,24,HLC,2725,23400.62,2313,19524.62,412,3876.00
16,24,HLC,2900,24923.84,2465,20843.84,435,4080.00
17,24,HLC,3067,26469.99,2626,22329.49,441,4140.50
18,24,HLC,2985,25501.05,2520,21356.05,465,4145.00
19,24,HLC,2918,24894.19,2502,21187.19,416,3707.00
20,24,HLC,2643,22684.69,2295,19577.19,348,3107.50
21,24,HLC,2320,19878.08,1979,16838.58,341,3039.50
22,24,HLC,2230,18975.05,1940,16413.05,290,2562.00
23,24,HLC,1961,16709.54,1667,14102.54,294,2607.00
0,25,HLC,1179,10105.28,1004,8585.28,175,1520.00
1,25,HLC,712,6108.58,597,5074.08,115,1034.50
2,25,HLC,365,3075.78,295,2444.28,70,631.50
3,25,HLC,226,1971.50,189,1597.50,37,374.00
4,25,HLC,175,1477.01,129,1025.51,46,451.50
5,25,HLC,210,1879.78,171,1393.78,39,486.00
6,25,HLC,401,3497.05,346,2877.55,55,619.50
7,25,HLC,651,5868.78,526,4460.78,125,1408.00
8,25,HLC,910,8121.10,776,6704.10,134,1417.00
9,25,HLC,1459,12595.52,1244,10476.52,215,2119.00
10,25,HLC,2137,18440.30,1866,15847.80,271,2592.50
11,25,HLC,2694,23367.30,2280,19520.30,414,3847.00
12,25,HLC,2525,21839.04,2120,18046.04,405,3793.00
13,25,HLC,3238,27917.05,2755,23364.55,483,4552.50
14,25,HLC,3329,28630.61,2819,23945.11,510,4685.50
15,25,HLC,3195,27490.39,2743,23364.89,452,4125.50
16,25,HLC,3634,31107.84,3095,26253.84,539,4854.00
17,25,HLC,3694,31665.30,3181,27013.80,513,4651.50
18,25,HLC,3615,30865.97,3089,26108.97,526,4757.00
19,25,HLC,3120,26630.68,2645,22451.18,475,4179.50
20,25,HLC,2549,21863.51,2166,18438.01,383,3425.50
21,25,HLC,1894,16269.54,1564,13303.54,330,2966.00
22,25,HLC,1318,11226.05,1097,9204.55,221,2021.50
23,25,HLC,863,7431.84,722,6134.84,141,1297.00
0,11,QMT,3342,28615.74,2691,22887.24,651,5728.50
1,11,QMT,2472,21171.41,2022,17212.91,450,3958.50
2,11,QMT,1554,13302.01,1263,10657.51,291,2644.50
3,11,QMT,1174,10029.28,956,8122.78,218,1906.50
4,11,QMT,1170,10050.26,969,8227.76,201,1822.50
5,11,QMT,1057,9138.66,875,7396.66,182,1742.00
6,11,QMT,1625,13875.38,1343,11331.38,282,2544.00
7,11,QMT,2184,18787.44,1786,14985.44,398,3802.00
8,11,QMT,2510,21613.47,1999,16919.97,511,4693.50
9,11,QMT,3139,27019.57,2553,21732.07,586,5287.50
10,11,QMT,3504,30198.03,2845,24247.03,659,5951.00
11,11,QMT,3798,32753.08,3035,25883.08,763,6870.00
12,11,QMT,4085,35204.34,3257,27841.34,828,7363.00
13,11,QMT,4344,37509.84,3498,29857.34,846,7652.50
14,11,QMT,4667,40212.53,3748,32029.03,919,8183.50
15,11,QMT,4906,42009.49,4007,34013.49,899,7996.00
16,11,QMT,5479,47117.54,4443,37782.54,1036,9335.00
17,11,QMT,5389,46775.79,4407,37671.79,982,9104.00
18,11,QMT,5264,45521.73,4258,36436.73,1006,9085.00
19,11,QMT,5025,43201.44,4095,34866.94,930,8334.50
20,11,QMT,4420,38038.91,3604,30795.91,816,7243.00
21,11,QMT,4316,36916.57,3557,30295.07,759,6621.50
22,11,QMT,3328,28510.52,2672,22750.52,656,5760.00
23,11,QMT,2437,20744.79,1986,16791.29,451,3953.50
0,12,QMT,1462,12480.04,1206,10183.04,256,2297.00
1,12,QMT,585,5041.50,438,3646.50,147,1395.00
2,12,QMT,388,3421.16,301,2540.66,87,880.50
3,12,QMT,342,3136.40,278,2350.40,64,786.00
4,12,QMT,828,7265.96,680,5722.96,148,1543.00
5,12,QMT,2223,21025.85,1750,15188.85,473,5837.00
6,12,QMT,3760,35380.95,2986,26162.45,774,9218.50
7,12,QMT,4108,39528.03,3200,27989.53,908,11538.50
8,12,QMT,4254,40469.56,3397,29681.06,857,10788.50
9,12,QMT,4219,39049.81,3350,29038.31,869,10011.50
10,12,QMT,4055,37366.59,3201,27840.59,854,9526.00
11,12,QMT,4342,39814.38,3429,30074.88,913,9739.50
12,12,QMT,4375,39983.94,3513,30675.94,862,9308.00
13,12,QMT,4419,40272.87,3551,30948.37,868,9324.50
14,12,QMT,4847,43999.67,3919,33876.67,928,10123.00
15,12,QMT,5261,47657.10,4228,36563.10,1033,11094.00
16,12,QMT,4793,42885.82,3872,33147.32,921,9738.50
17,12,QMT,5408,47943.30,4454,38121.80,954,9821.50
18,12,QMT,4542,40040.07,3729,32010.57,813,8029.50
19,12,QMT,3739,32768.29,3060,26277.29,679,6491.00
20,12,QMT,3524,30495.67,2913,24809.17,611,5686.50
21,12,QMT,3360,29301.48,2763,23678.48,597,5623.00
22,12,QMT,2280,19775.56,1861,15784.56,419,3991.00
23,12,QMT,1972,16830.51,1638,13848.01,334,2982.50
0,13,QMT,1405,12207.84,1162,9829.34,243,2378.50
1,13,QMT,695,6294.76,545,4607.76,150,1687.00
2,13,QMT,316,2831.27,257,2180.27,59,651.00
3,13,QMT,308,2850.04,233,1972.04,75,878.00
4,13,QMT,784,7288.08,602,5050.58,182,2237.50
5,13,QMT,2124,20513.62,1624,14205.12,500,6308.50
6,13,QMT,4028,39004.71,3133,27600.71,895,11404.00
7,13,QMT,4715,45158.01,3654,31869.51,1061,13288.50
8,13,QMT,4777,45937.66,3713,32465.66,1064,13472.00
9,13,QMT,4622,43650.10,3656,32136.60,966,11513.50
10,13,QMT,4175,39889.51,3273,29134.51,902,10755.00
11,13,QMT,4401,41599.25,3481,30744.75,920,10854.50
12,13,QMT,4700,44073.51,3685,32586.01,1015,11487.50
13,13,QMT,4883,45350.75,3889,34050.75,994,11300.00
14,13,QMT,5145,47984.12,4079,35653.12,1066,12331.00
15,13,QMT,5380,50016.46,4249,37005.46,1131,13011.00
16,13,QMT,5398,49713.69,4385,37868.69,1013,11845.00
17,13,QMT,5142,46200.15,4191,35868.65,951,10331.50
18,13,QMT,6145,54147.24,3871,33318.24,2274,20829.00
19,13,QMT,4219,37022.82,3453,29402.82,766,7620.00
20,13,QMT,3958,34679.83,3309,28301.33,649,6378.50
21,13,QMT,3620,31390.11,3050,25913.61,570,5476.50
22,13,QMT,2545,22267.81,2120,18056.31,425,4211.50
23,13,QMT,1671,14386.94,1400,11793.44,271,2593.50
0,14,QMT,1660,14582.96,1366,11477.46,294,3105.50
1,14,QMT,704,6257.47,565,4807.97,139,1449.50
2,14,QMT,397,3446.77,305,2483.77,92,963.00
3,14,QMT,369,3364.50,284,2399.50,85,965.00
4,14,QMT,846,7742.05,681,5863.55,165,1878.50
5,14,QMT,2257,22037.98,1724,15247.48,533,6790.50
6,14,QMT,4052,39537.56,3081,27253.06,971,12284.50
7,14,QMT,4766,46359.35,3681,32330.85,1085,14028.50
8,14,QMT,5034,48495.76,3925,34546.76,1109,13949.00
9,14,QMT,4976,46896.52,3867,33863.02,1109,13033.50
10,14,QMT,4080,38600.80,3247,28788.80,833,9812.00
11,14,QMT,4516,42249.22,3580,31539.22,936,10710.00
12,14,QMT,4678,43603.94,3713,32645.94,965,10958.00
13,14,QMT,5115,47479.27,4069,35586.27,1046,11893.00
14,14,QMT,5380,49757.96,4274,37241.96,1106,12516.00
15,14,QMT,5382,50225.84,4286,37303.34,1096,12922.50
16,14,QMT,5447,50359.23,4339,37559.23,1108,12800.00
17,14,QMT,5537,49988.82,4559,39393.32,978,10595.50
18,14,QMT,5188,45912.18,4248,36334.68,940,9577.50
19,14,QMT,4974,43665.31,4089,34927.31,885,8738.00
20,14,QMT,4613,40256.41,3826,32549.91,787,7706.50
21,14,QMT,2804,24476.76,2318,19682.26,486,4794.50
22,14,QMT,2374,20787.83,1962,16675.33,412,4112.50
23,14,QMT,2139,18505.96,1824,15374.46,315,3131.50
0,15,QMT,1817,15941.94,1506,12736.94,311,3205.00
1,15,QMT,877,7750.43,693,5908.93,184,1841.50
2,15,QMT,497,4417.43,393,3290.43,104,1127.00
3,15,QMT,445,4123.06,346,2941.06,99,1182.00
4,15,QMT,910,8298.71,746,6403.21,164,1895.50
5,15,QMT,2345,22880.69,1797,15837.19,548,7043.50
6,15,QMT,4337,41584.06,3386,29529.06,951,12055.00
7,15,QMT,4827,45674.37,3817,33259.37,1010,12415.00
8,15,QMT,4884,47160.02,3811,33635.52,1073,13524.50
9,15,QMT,4854,45339.67,3860,33774.67,994,11565.00
10,15,QMT,4113,38468.64,3279,28933.64,834,9535.00
11,15,QMT,4766,44395.68,3825,33472.68,941,10923.00
12,15,QMT,4853,45029.48,3825,33425.48,1028,11604.00
13,15,QMT,5082,46890.65,4036,34999.65,1046,11891.00
14,15,QMT,4458,41424.22,3505,30488.72,953,10935.50
15,15,QMT,3971,37288.88,3085,26698.88,886,10590.00
16,15,QMT,3320,30772.90,2569,21951.40,751,8821.50
17,15,QMT,2380,22047.35,1818,15554.85,562,6492.50
18,15,QMT,2584,23962.54,1937,16497.54,647,7465.00
19,15,QMT,2969,27447.49,2310,19715.49,659,7732.00
20,15,QMT,3635,33376.00,2874,24597.00,761,8779.00
21,15,QMT,3765,34139.73,3040,25993.73,725,8146.00
22,15,QMT,3305,30480.45,2641,22570.45,664,7910.00
23,15,QMT,4102,36379.50,3324,28384.50,778,7995.00
0,16,QMT,3439,30083.85,2877,24371.35,562,5712.50
1,16,QMT,1889,16585.32,1614,13764.32,275,2821.00
2,16,QMT,1165,10259.32,985,8480.32,180,1779.00
3,16,QMT,835,7355.55,697,5861.05,138,1494.50
4,16,QMT,1283,11356.85,1073,9136.35,210,2220.50
5,16,QMT,2349,22377.14,1871,16470.64,478,5906.50
6,16,QMT,3822,36481.16,2970,26043.66,852,10437.50
7,16,QMT,4353,42116.53,3362,29267.03,991,12849.50
8,16,QMT,4674,44946.37,3621,31913.87,1053,13032.50
9,16,QMT,4620,43945.51,3593,31558.51,1027,12387.00
10,16,QMT,3798,35720.33,2975,26168.33,823,9552.00
11,16,QMT,4294,40034.23,3384,29687.73,910,10346.50
12,16,QMT,4922,45511.09,3923,34218.59,999,11292.50
13,16,QMT,5138,47144.16,4076,35295.16,1062,11849.00
14,16,QMT,5114,46839.73,4106,35694.73,1008,11145.00
15,16,QMT,5215,47985.67,4140,35884.17,1075,12101.50
16,16,QMT,5197,47729.36,4217,36593.36,980,11136.00
17,16,QMT,5180,46729.09,4194,35970.09,986,10759.00
18,16,QMT,4649,41444.35,3798,32724.85,851,8719.50
19,16,QMT,4349,38153.57,3528,30156.07,821,7997.50
20,16,QMT,4157,36559.61,3405,29120.61,752,7439.00
21,16,QMT,3614,31487.25,3028,25882.25,586,5605.00
22,16,QMT,3488,30561.28,2859,24409.78,629,6151.50
23,16,QMT,2948,25582.98,2425,20609.48,523,4973.50
0,17,QMT,2688,23290.62,2213,18788.62,475,4502.00
1,17,QMT,1845,16034.76,1514,12829.76,331,3205.00
2,17,QMT,1202,10595.37,967,8283.37,235,2312.00
3,17,QMT,960,8509.50,781,6643.50,179,1866.00
4,17,QMT,1119,9795.26,931,7893.76,188,1901.50
5,17,QMT,1434,13296.81,1173,10182.31,261,3114.50
6,17,QMT,2202,20568.32,1728,15050.82,474,5517.50
7,17,QMT,2963,26830.78,2411,20766.28,552,6064.50
8,17,QMT,3533,31583.66,2869,24869.66,664,6714.00
9,17,QMT,4164,36931.20,3381,29237.70,783,7693.50
10,17,QMT,4115,36440.49,3286,28286.99,829,8153.50
11,17,QMT,4279,37848.35,3394,29179.35,885,8669.00
12,17,QMT,4473,39193.61,3535,30401.61,938,8792.00
13,17,QMT,4579,40168.81,3707,31807.31,872,8361.50
14,17,QMT,4717,41255.00,3759,32095.50,958,9159.50
15,17,QMT,4850,42341.03,3916,33473.03,934,8868.00
16,17,QMT,4859,42406.68,3932,33486.18,927,8920.50
17,17,QMT,5240,45572.79,4255,36398.29,985,9174.50
18,17,QMT,4909,42433.14,3907,33343.64,1002,9089.50
19,17,QMT,4414,38183.24,3579,30521.74,835,7661.50
20,17,QMT,3966,34341.19,3197,27334.69,769,7006.50
21,17,QMT,3597,30883.97,2934,24931.47,663,5952.50
22,17,QMT,3986,34197.22,3276,27916.72,710,6280.50
23,17,QMT,3929,33498.02,3204,27157.02,725,6341.00
0,18,QMT,3249,27686.06,2653,22486.56,596,5199.50
1,18,QMT,2365,20119.21,1919,16227.71,446,3891.50
2,18,QMT,1571,13491.60,1265,10691.60,306,2800.00
3,18,QMT,1186,10134.76,958,8038.26,228,2096.50
4,18,QMT,1224,10516.02,978,8242.02,246,2274.00
5,18,QMT,1137,9777.66,954,8065.66,183,1712.00
6,18,QMT,1563,13651.80,1312,11194.30,251,2457.50
7,18,QMT,2081,18148.02,1686,14339.02,395,3809.00
8,18,QMT,2319,20126.93,1885,16082.43,434,4044.50
9,18,QMT,3094,27009.74,2563,21982.74,531,5027.00
10,18,QMT,3730,32190.54,3045,25998.04,685,6192.50
11,18,QMT,4040,34906.85,3260,27843.85,780,7063.00
12,18,QMT,4464,38471.72,3675,31427.72,789,7044.00
13,18,QMT,4661,40212.81,3792,32378.81,869,7834.00
14,18,QMT,4703,40854.60,3800,32527.60,903,8327.00
15,18,QMT,5159,44748.23,4221,36062.73,938,8685.50
16,18,QMT,5128,44240.24,4167,35648.74,961,8591.50
17,18,QMT,5029,43434.28,4116,35123.78,913,8310.50
18,18,QMT,5040,43620.71,4056,34722.21,984,8898.50
19,18,QMT,4645,39904.18,3784,32247.68,861,7656.50
20,18,QMT,3332,28966.77,2703,23130.77,629,5836.00
21,18,QMT,2865,24711.29,2311,19683.79,554,5027.50
22,18,QMT,2596,22515.56,2101,17824.06,495,4691.50
23,18,QMT,2117,18257.27,1706,14465.27,411,3792.00
0,19,QMT,1139,9756.48,909,7688.48,230,2068.00
1,19,QMT,504,4420.76,385,3263.76,119,1157.00
2,19,QMT,346,3096.80,269,2309.80,77,787.00
3,19,QMT,333,3030.68,249,2140.68,84,890.00
4,19,QMT,789,7279.83,617,5300.83,172,1979.00
5,19,QMT,2252,21908.67,1740,15428.17,512,6480.50
6,19,QMT,4132,39920.09,3167,28005.09,965,11915.00
7,19,QMT,4796,45837.08,3717,32451.58,1079,13385.50
8,19,QMT,4648,44684.42,3670,32214.92,978,12469.50
9,19,QMT,4482,42727.48,3511,30895.98,971,11831.50
10,19,QMT,4149,39251.95,3207,28478.45,942,10773.50
11,19,QMT,4512,41973.66,3524,30808.16,988,11165.50
12,19,QMT,4531,42258.46,3495,30652.46,1036,11606.00
13,19,QMT,4630,43760.11,3577,31453.11,1053,12307.00
14,19,QMT,4875,45614.56,3773,33194.06,1102,12420.50
15,19,QMT,5352,49702.75,4149,36039.25,1203,13663.50
16,19,QMT,5344,49009.25,4261,36932.75,1083,12076.50
17,19,QMT,5188,47050.56,4212,36602.56,976,10448.00
18,19,QMT,4771,42375.79,3839,32967.79,932,9408.00
19,19,QMT,3869,33935.16,3151,27027.16,718,6908.00
20,19,QMT,3518,30859.01,2951,25302.51,567,5556.50
21,19,QMT,2890,25230.47,2388,20411.47,502,4819.00
22,19,QMT,2331,20423.30,1880,16018.30,451,4405.00
23,19,QMT,1734,14867.44,1410,11884.44,324,2983.00
0,20,QMT,1422,12320.15,1178,9921.15,244,2399.00
1,20,QMT,650,5828.58,513,4339.08,137,1489.50
2,20,QMT,472,4172.47,372,3119.47,100,1053.00
3,20,QMT,403,3675.07,312,2620.07,91,1055.00
4,20,QMT,855,7903.77,697,5994.27,158,1909.50
5,20,QMT,2341,22929.94,1784,15806.44,557,7123.50
6,20,QMT,4109,39842.77,3152,27810.27,957,12032.50
7,20,QMT,4813,46360.51,3693,32158.51,1120,14202.00
8,20,QMT,4857,47454.09,3740,33200.59,1117,14253.50
9,20,QMT,4846,45791.10,3792,33373.60,1054,12417.50
10,20,QMT,3445,32687.39,2651,23394.89,794,9292.50
11,20,QMT,4297,39966.96,3413,29892.96,884,10074.00
12,20,QMT,4774,44322.25,3759,33043.25,1015,11279.00
13,20,QMT,5087,47517.97,4022,35484.97,1065,12033.00
14,20,QMT,5363,50051.66,4195,36683.66,1168,13368.00
15,20,QMT,5497,50489.10,4311,37237.60,1186,13251.50
16,20,QMT,5390,49520.17,4280,37000.67,1110,12519.50
17,20,QMT,5224,46944.38,4226,36403.38,998,10541.00
18,20,QMT,5031,44934.07,4047,34865.07,984,10069.00
19,20,QMT,4784,41966.78,3880,33116.28,904,8850.50
20,20,QMT,4463,39333.04,3593,30687.04,870,8646.00
21,20,QMT,3535,30977.60,2920,24998.60,615,5979.00
22,20,QMT,2516,22068.39,2042,17473.39,474,4595.00
23,20,QMT,2043,18091.34,1637,14006.34,406,4085.00
0,21,QMT,1669,14670.01,1374,11771.01,295,2899.00
1,21,QMT,940,8515.79,757,6496.29,183,2019.50
2,21,QMT,515,4645.08,387,3285.08,128,1360.00
3,21,QMT,525,4834.90,412,3544.90,113,1290.00
4,21,QMT,1070,9821.91,871,7527.91,199,2294.00
5,21,QMT,2366,23103.96,1830,16213.96,536,6890.00
6,21,QMT,4129,39884.61,3168,27773.61,961,12111.00
7,21,QMT,4323,42015.13,3374,29953.13,949,12062.00
8,21,QMT,4806,46541.02,3735,33295.02,1071,13246.00
9,21,QMT,4603,43780.16,3549,31567.16,1054,12213.00
10,21,QMT,4247,40391.29,3295,29243.29,952,11148.00
11,21,QMT,4846,45653.72,3754,33086.72,1092,12567.00
12,21,QMT,4939,45825.37,3785,32898.87,1154,12926.50
13,21,QMT,4334,39511.89,3432,29878.89,902,9633.00
14,21,QMT,5262,48665.31,4196,36505.81,1066,12159.50
15,21,QMT,4996,45828.74,3983,34721.24,1013,11107.50
16,21,QMT,5416,49181.35,4330,37487.85,1086,11693.50
17,21,QMT,4832,43343.07,3884,33633.57,948,9709.50
18,21,QMT,4300,37977.12,3422,29395.62,878,8581.50
19,21,QMT,3932,34256.31,3093,26383.31,839,7873.00
20,21,QMT,3410,29830.69,2711,23175.19,699,6655.50
21,21,QMT,3190,27931.60,2548,21743.10,642,6188.50
22,21,QMT,2950,25583.49,2371,20195.99,579,5387.50
23,21,QMT,2371,20530.83,1901,16253.33,470,4277.50
0,22,QMT,1824,15574.77,1485,12506.77,339,3068.00
1,22,QMT,970,8367.76,765,6491.76,205,1876.00
2,22,QMT,726,6213.01,596,5014.51,130,1198.50
3,22,QMT,740,6332.58,603,5029.58,137,1303.00
4,22,QMT,1003,8461.36,796,6522.36,207,1939.00
5,22,QMT,1197,10157.91,1008,8352.41,189,1805.50
6,22,QMT,1580,13624.68,1301,10929.18,279,2695.50
7,22,QMT,1569,13596.74,1286,10903.74,283,2693.00
8,22,QMT,1579,13619.61,1293,10835.11,286,2784.50
9,22,QMT,1647,14394.59,1364,11760.09,283,2634.50
10,22,QMT,1887,16287.67,1545,13160.67,342,3127.00
11,22,QMT,2610,22546.77,2102,17881.77,508,4665.00
12,22,QMT,3625,31420.38,2921,25056.88,704,6363.50
13,22,QMT,3986,33943.82,3176,26796.82,810,7147.00
14,22,QMT,4132,35578.91,3309,28285.41,823,7293.50
15,22,QMT,3725,32040.62,2990,25321.62,735,6719.00
16,22,QMT,3192,27632.08,2584,22048.58,608,5583.50
17,22,QMT,2754,23947.81,2196,18773.31,558,5174.50
18,22,QMT,2498,21447.91,2018,17140.91,480,4307.00
19,22,QMT,2768,23849.18,2278,19461.68,490,4387.50
20,22,QMT,3039,26022.19,2522,21415.19,517,4607.00
21,22,QMT,3448,29385.16,2817,23873.66,631,5511.50
22,22,QMT,3380,28972.67,2663,22635.67,717,6337.00
23,22,QMT,2840,24219.90,2234,18938.90,606,5281.00
0,23,QMT,1351,11531.79,1078,9121.79,273,2410.00
1,23,QMT,694,5934.00,551,4649.50,143,1284.50
2,23,QMT,450,3894.00,357,3017.50,93,876.50
3,23,QMT,395,3491.50,312,2696.00,83,795.50
4,23,QMT,574,5081.92,460,3950.42,114,1131.50
5,23,QMT,1092,10000.11,862,7427.11,230,2573.00
6,23,QMT,1811,16862.77,1414,12346.27,397,4516.50
7,23,QMT,2124,19788.62,1650,14339.12,474,5449.50
8,23,QMT,2325,21804.04,1819,15967.54,506,5836.50
9,23,QMT,2471,22828.97,1937,17004.47,534,5824.50
10,23,QMT,2761,25160.93,2148,18676.93,613,6484.00
11,23,QMT,3247,29260.63,2536,22135.13,711,7125.50
12,23,QMT,3397,30364.36,2607,22573.36,790,7791.00
13,23,QMT,3717,32841.76,2933,25262.26,784,7579.50
14,23,QMT,3823,33864.57,3032,26027.07,791,7837.50
15,23,QMT,3873,34156.98,3056,26199.98,817,7957.00
16,23,QMT,3756,33488.26,2986,25693.76,770,7794.50
17,23,QMT,3522,30912.39,2781,23846.89,741,7065.50
18,23,QMT,3322,29211.28,2656,22762.28,666,6449.00
19,23,QMT,2947,25791.72,2350,20081.22,597,5710.50
20,23,QMT,2687,23344.15,2086,17779.15,601,5565.00
21,23,QMT,2457,21297.49,1953,16589.99,504,4707.50
22,23,QMT,2413,21018.44,1913,16437.94,500,4580.50
23,23,QMT,2241,19157.02,1780,15009.52,461,4147.50
0,24,QMT,1599,13797.28,1252,10658.78,347,3138.50
1,24,QMT,1081,9405.32,858,7324.32,223,2081.00
2,24,QMT,848,7303.92,665,5600.42,183,1703.50
3,24,QMT,704,6091.52,570,4814.02,134,1277.50
4,24,QMT,843,7328.00,678,5740.00,165,1588.00
5,24,QMT,1081,9582.55,874,7376.55,207,2206.00
6,24,QMT,1481,13620.24,1173,10207.24,308,3413.00
7,24,QMT,1862,16978.52,1500,13144.52,362,3834.00
8,24,QMT,2257,20601.87,1829,16172.37,428,4429.50
9,24,QMT,2625,23796.72,2105,18655.22,520,5141.50
10,24,QMT,3173,28410.54,2561,22214.04,612,6196.50
11,24,QMT,3578,31637.79,2879,24861.29,699,6776.50
12,24,QMT,3981,35016.58,3179,27529.08,802,7487.50
13,24,QMT,4120,35987.67,3313,28441.17,807,7546.50
14,24,QMT,4212,36663.04,3413,29200.04,799,7463.00
15,24,QMT,4509,38944.96,3631,30875.96,878,8069.00
16,24,QMT,4608,39960.89,3715,31651.89,893,8309.00
17,24,QMT,4758,40955.97,3821,32581.47,937,8374.50
18,24,QMT,4160,35799.49,3368,28614.49,792,7185.00
19,24,QMT,4124,35674.57,3248,27885.07,876,7789.50
20,24,QMT,3872,33488.84,3065,26253.84,807,7235.00
21,24,QMT,3800,32874.06,3087,26358.56,713,6515.50
22,24,QMT,3559,30517.66,2892,24605.16,667,5912.50
23,24,QMT,3452,29438.92,2743,23231.92,709,6207.00
0,25,QMT,3020,25869.22,2064,17438.22,956,8431.00
1,25,QMT,1925,16489.75,1440,12213.25,485,4276.50
2,25,QMT,1483,12641.76,867,7307.26,616,5334.50
3,25,QMT,858,7228.02,663,5494.02,195,1734.00
4,25,QMT,986,8520.16,793,6691.16,193,1829.00
5,25,QMT,1173,10143.80,976,8268.30,197,1875.50
6,25,QMT,1609,13875.19,1311,11128.69,298,2746.50
7,25,QMT,2060,17783.20,1704,14470.20,356,3313.00
8,25,QMT,2514,21821.29,2056,17616.79,458,4204.50
9,25,QMT,3265,28144.18,2624,22373.18,641,5771.00
10,25,QMT,3796,32601.19,3090,26247.19,706,6354.00
11,25,QMT,4230,36505.56,3390,28983.56,840,7522.00
12,25,QMT,4357,37563.29,3504,29867.29,853,7696.00
13,25,QMT,4552,39234.63,3674,31435.63,878,7799.00
14,25,QMT,4975,43101.46,4063,34843.46,912,8258.00
15,25,QMT,5099,43968.96,4171,35590.96,928,8378.00
16,25,QMT,5403,46641.64,4446,38017.14,957,8624.50
17,25,QMT,5335,45896.69,4337,37060.69,998,8836.00
18,25,QMT,5153,44440.43,4171,35657.93,982,8782.50
19,25,QMT,5001,43187.53,4061,34736.53,940,8451.00
20,25,QMT,4337,37306.30,3530,30057.80,807,7248.50
21,25,QMT,4119,35496.45,3364,28803.95,755,6692.50
22,25,QMT,2710,23424.48,2216,19049.98,494,4374.50
23,25,QMT,2240,19209.69,1853,15699.19,387,3510.50
0,11,RFK,3770,33332.44,2860,25010.94,910,8321.50
1,11,RFK,2413,21323.82,1873,16252.32,540,5071.50
2,11,RFK,1903,17244.79,1438,12822.29,465,4422.50
3,11,RFK,1616,14798.54,1189,10561.04,427,4237.50
4,11,RFK,1732,15516.27,1293,11282.27,439,4234.00
5,11,RFK,1823,16724.07,1435,12462.57,388,4261.50
6,11,RFK,2707,24334.51,2173,19008.51,534,5326.00
7,11,RFK,3372,30230.53,2664,23137.03,708,7093.50
8,11,RFK,4154,37574.47,3346,29515.97,808,8058.50
9,11,RFK,5570,49705.32,4534,39697.32,1036,10008.00
10,11,RFK,7547,66525.80,6087,52935.30,1460,13590.50
11,11,RFK,8117,70419.00,6601,56716.00,1516,13703.00
12,11,RFK,8145,71030.89,6563,56325.89,1582,14705.00
13,11,RFK,8149,70791.48,6566,56166.98,1583,14624.50
14,11,RFK,8521,74153.34,6907,59165.34,1614,14988.00
15,11,RFK,8599,74696.47,7059,60413.97,1540,14282.50
16,11,RFK,8690,76122.61,7111,61276.61,1579,14846.00
17,11,RFK,8002,69494.58,6550,56157.08,1452,13337.50
18,11,RFK,7817,68525.06,6385,55192.56,1432,13332.50
19,11,RFK,7622,67114.20,6239,54084.20,1383,13030.00
20,11,RFK,6422,56458.83,5318,45844.83,1104,10614.00
21,11,RFK,5582,49835.06,4553,39867.06,1029,9968.00
22,11,RFK,4495,40187.96,3641,32019.46,854,8168.50
23,11,RFK,3503,31709.29,2809,24969.79,694,6739.50
0,12,RFK,2175,20117.81,1672,14893.31,503,5224.50
1,12,RFK,1266,12957.71,924,9088.71,342,3869.00
2,12,RFK,937,10878.10,688,7280.10,249,3598.00
3,12,RFK,968,11191.56,692,7509.56,276,3682.00
4,12,RFK,1877,20786.21,1438,14617.21,439,6169.00
5,12,RFK,4135,45103.98,3245,32101.98,890,13002.00
6,12,RFK,8234,84796.93,6567,62299.43,1667,22497.50
7,12,RFK,8302,83705.80,6584,61735.80,1718,21970.00
8,12,RFK,8097,81156.97,6429,60212.97,1668,20944.00
9,12,RFK,7730,79485.35,6148,58979.85,1582,20505.50
10,12,RFK,7474,75427.00,5894,55558.50,1580,19868.50
11,12,RFK,7232,73263.05,5696,53961.55,1536,19301.50
12,12,RFK,7445,73620.34,5834,54240.84,1611,19379.50
13,12,RFK,7356,71509.88,5779,52896.88,1577,18613.00
14,12,RFK,7434,71774.40,5869,53572.40,1565,18202.00
15,12,RFK,7761,73187.52,6229,56060.52,1532,17127.00
16,12,RFK,7498,69928.06,6048,53764.06,1450,16164.00
17,12,RFK,7257,65646.81,5896,51454.31,1361,14192.50
18,12,RFK,6704,59993.91,5437,47426.41,1267,12567.50
19,12,RFK,6015,55195.91,4852,43125.91,1163,12070.00
20,12,RFK,4841,43955.69,3928,34497.19,913,9458.50
21,12,RFK,4255,39195.36,3376,29921.86,879,9273.50
22,12,RFK,3536,32634.34,2792,24837.84,744,7796.50
23,12,RFK,2783,26307.51,2164,19515.51,619,6792.00
0,13,RFK,1817,17952.81,1360,12564.81,457,5388.00
1,13,RFK,991,11523.85,676,6943.35,315,4580.50
2,13,RFK,713,9463.05,526,6139.05,187,3324.00
3,13,RFK,930,12487.20,640,7470.70,290,5016.50
4,13,RFK,1844,22031.83,1412,14982.33,432,7049.50
5,13,RFK,5271,56473.75,4180,40108.25,1091,16365.50
6,13,RFK,9038,90045.65,7223,65999.15,1815,24046.50
7,13,RFK,9004,88671.14,7168,65348.64,1836,23322.50
8,13,RFK,8372,85855.74,6534,60680.74,1838,25175.00
9,13,RFK,7623,77622.71,5954,56063.21,1669,21559.50
10,13,RFK,7695,80646.89,6004,57310.39,1691,23336.50
11,13,RFK,8054,82935.34,6344,60004.34,1710,22931.00
12,13,RFK,8029,82285.20,6229,58794.70,1800,23490.50
13,13,RFK,7447,77424.65,5774,55155.65,1673,22269.00
14,13,RFK,8320,83547.63,6453,59909.13,1867,23638.50
15,13,RFK,8680,85001.85,6847,62582.35,1833,22419.50
16,13,RFK,8606,81431.14,6906,62039.14,1700,19392.00
17,13,RFK,8038,74010.78,6564,57921.78,1474,16089.00
18,13,RFK,7141,65073.24,5870,51679.74,1271,13393.50
19,13,RFK,5988,54938.07,4900,43665.57,1088,11272.50
20,13,RFK,5032,46369.61,4028,35187.11,1004,11182.50
21,13,RFK,4293,40300.32,3457,31102.32,836,9198.00
22,13,RFK,3753,34711.20,2999,26605.70,754,8105.50
23,13,RFK,3154,30000.85,2473,22581.85,681,7419.00
0,14,RFK,2125,21090.28,1668,15645.78,457,5444.50
1,14,RFK,1034,12141.81,742,7764.81,292,4377.00
2,14,RFK,805,10129.00,562,6445.00,243,3684.00
3,14,RFK,919,12820.30,624,7764.30,295,5056.00
4,14,RFK,1786,20618.26,1369,14196.26,417,6422.00
5,14,RFK,5383,57324.83,4343,41341.83,1040,15983.00
6,14,RFK,9699,97376.78,7792,71630.28,1907,25746.50
7,14,RFK,10281,103533.29,8194,75850.29,2087,27683.00
8,14,RFK,8363,86112.63,6534,61073.13,1829,25039.50
9,14,RFK,7842,82954.14,6149,58893.64,1693,24060.50
10,14,RFK,7967,82154.03,6320,60125.53,1647,22028.50
11,14,RFK,7751,80130.34,5992,56722.84,1759,23407.50
12,14,RFK,7629,77488.44,5765,54455.44,1864,23033.00
13,14,RFK,8110,82330.01,6042,56961.01,2068,25369.00
14,14,RFK,9198,89660.40,6973,63434.90,2225,26225.50
15,14,RFK,8980,86027.64,6786,60612.64,2194,25415.00
16,14,RFK,8740,81858.56,6742,59245.06,1998,22613.50
17,14,RFK,8786,80152.12,6709,58640.62,2077,21511.50
18,14,RFK,8399,75120.25,6260,54602.75,2139,20517.50
19,14,RFK,7842,70682.84,5936,51833.84,1906,18849.00
20,14,RFK,6455,58848.62,4989,43374.62,1466,15474.00
21,14,RFK,5517,50416.48,4253,37530.98,1264,12885.50
22,14,RFK,4683,42628.91,3706,32738.91,977,9890.00
23,14,RFK,3762,35744.82,2976,27100.32,786,8644.50
0,15,RFK,2190,21451.14,1641,15081.64,549,6369.50
1,15,RFK,1375,16087.89,837,9038.64,538,7049.25
2,15,RFK,1007,11963.93,638,6975.43,369,4988.50
3,15,RFK,1037,13049.09,692,8179.09,345,4870.00
4,15,RFK,1929,23115.68,1403,15056.68,526,8059.00
5,15,RFK,5332,56320.46,4293,40632.96,1039,15687.50
6,15,RFK,9234,94856.26,7387,68880.76,1847,25975.50
7,15,RFK,9748,98739.74,7788,72415.74,1960,26324.00
8,15,RFK,8151,86360.63,6364,61102.63,1787,25258.00
9,15,RFK,8309,88084.65,6414,61686.15,1895,26398.50
10,15,RFK,8218,86342.52,6436,61844.52,1782,24498.00
11,15,RFK,8105,83908.86,6272,59253.36,1833,24655.50
12,15,RFK,7613,79383.85,5879,56255.85,1734,23128.00
13,15,RFK,7380,74745.47,5738,53132.47,1642,21613.00
14,15,RFK,7505,74695.14,5824,53603.14,1681,21092.00
15,15,RFK,6196,59945.80,4833,43272.30,1363,16673.50
16,15,RFK,4463,42251.04,3438,30164.54,1025,12086.50
17,15,RFK,2550,23882.86,1936,16627.86,614,7255.00
18,15,RFK,2091,19910.17,1611,13955.67,480,5954.50
19,15,RFK,2732,26050.11,2053,17969.61,679,8080.50
20,15,RFK,2578,24626.14,1950,16968.14,628,7658.00
21,15,RFK,3142,29615.51,2450,21560.01,692,8055.50
22,15,RFK,2549,23628.85,1970,17169.35,579,6459.50
23,15,RFK,2313,21928.10,1831,16500.60,482,5427.50
0,16,RFK,2195,21264.82,1735,15921.32,460,5343.50
1,16,RFK,1784,17297.79,1387,12748.29,397,4549.50
2,16,RFK,1573,15684.32,1236,11353.32,337,4331.00
3,16,RFK,1357,14612.22,1067,10866.22,290,3746.00
4,16,RFK,1735,19299.08,1350,13501.58,385,5797.50
5,16,RFK,3983,42089.91,3191,30822.41,792,11267.50
6,16,RFK,7174,72863.96,5727,53206.46,1447,19657.50
7,16,RFK,8466,86265.50,6702,62951.50,1764,23314.00
8,16,RFK,8100,83533.94,6366,60124.94,1734,23409.00
9,16,RFK,6948,73321.36,5424,52453.86,1524,20867.50
10,16,RFK,6956,72192.40,5468,52198.40,1488,19994.00
11,16,RFK,6556,69604.86,5088,49779.36,1468,19825.50
12,16,RFK,6914,70538.16,5476,52367.66,1438,18170.50
13,16,RFK,7724,77249.72,6044,56373.72,1680,20876.00
14,16,RFK,8293,81710.88,6559,60897.38,1734,20813.50
15,16,RFK,8026,77141.44,6378,57662.94,1648,19478.50
16,16,RFK,8227,76446.17,6573,58737.67,1654,17708.50
17,16,RFK,7290,67429.06,5946,52617.06,1344,14812.00
18,16,RFK,7134,64834.07,5782,50999.57,1352,13834.50
19,16,RFK,6348,57571.91,5071,44553.41,1277,13018.50
20,16,RFK,5668,51569.23,4505,39494.73,1163,12074.50
21,16,RFK,5226,47030.09,4173,36475.09,1053,10555.00
22,16,RFK,4496,40829.22,3597,31614.22,899,9215.00
23,16,RFK,4210,38586.16,3382,29895.16,828,8691.00
0,17,RFK,3426,31594.66,2735,24458.16,691,7136.50
1,17,RFK,2160,20698.96,1663,15374.96,497,5324.00
2,17,RFK,1619,16717.33,1245,11901.33,374,4816.00
3,17,RFK,1432,14915.99,1079,10488.99,353,4427.00
4,17,RFK,1810,18791.28,1317,12352.78,493,6438.50
5,17,RFK,2500,25717.34,1941,18019.34,559,7698.00
6,17,RFK,4120,43461.30,3224,30753.80,896,12707.50
7,17,RFK,4686,46639.01,3676,33854.01,1010,12785.00
8,17,RFK,5215,50691.14,4133,37533.64,1082,13157.50
9,17,RFK,6033,57569.81,4834,44206.81,1199,13363.00
10,17,RFK,6551,61636.64,5247,47749.14,1304,13887.50
11,17,RFK,6466,59625.60,5179,46226.10,1287,13399.50
12,17,RFK,6831,62348.71,5438,47963.71,1393,14385.00
13,17,RFK,7246,66015.22,5775,50701.22,1471,15314.00
14,17,RFK,7383,67021.80,5878,51413.30,1505,15608.50
15,17,RFK,7595,68311.36,6038,52874.86,1557,15436.50
16,17,RFK,7300,65346.46,5903,51643.46,1397,13703.00
17,17,RFK,7396,65271.47,6000,51891.47,1396,13380.00
18,17,RFK,6535,57848.81,5273,45777.31,1262,12071.50
19,17,RFK,7205,63375.85,5711,49530.35,1494,13845.50
20,17,RFK,6203,54466.95,4917,42531.45,1286,11935.50
21,17,RFK,5594,49135.39,4427,38216.39,1167,10919.00
22,17,RFK,5172,45430.83,4095,35372.33,1077,10058.50
23,17,RFK,4887,42851.55,3903,33823.05,984,9028.50
0,18,RFK,3724,32477.96,2930,25251.96,794,7226.00
1,18,RFK,2635,23311.56,2011,17541.56,624,5770.00
2,18,RFK,2089,19463.32,1597,14608.32,492,4855.00
3,18,RFK,1746,16279.03,1266,11407.03,480,4872.00
4,18,RFK,1902,17028.68,1412,12280.68,490,4748.00
5,18,RFK,1881,17567.28,1438,12649.78,443,4917.50
6,18,RFK,2711,25221.94,2175,19333.94,536,5888.00
7,18,RFK,3194,29740.27,2517,22426.77,677,7313.50
8,18,RFK,3784,34577.63,3000,26608.63,784,7969.00
9,18,RFK,5115,45979.22,4164,36656.22,951,9323.00
10,18,RFK,6722,59714.27,5442,47566.27,1280,12148.00
11,18,RFK,7252,63976.43,5875,50876.43,1377,13100.00
12,18,RFK,7563,66005.96,6097,52297.96,1466,13708.00
13,18,RFK,7737,67568.88,6267,53827.38,1470,13741.50
14,18,RFK,8166,71265.37,6603,56566.87,1563,14698.50
15,18,RFK,8482,74870.34,6904,59969.84,1578,14900.50
16,18,RFK,8298,72652.79,6804,58433.79,1494,14219.00
17,18,RFK,7768,68246.93,6302,54566.43,1466,13680.50
18,18,RFK,6912,60553.59,5681,49061.59,1231,11492.00
19,18,RFK,6406,56618.58,5249,45552.08,1157,11066.50
20,18,RFK,5793,51013.94,4726,40967.94,1067,10046.00
21,18,RFK,4851,43600.81,3912,34059.31,939,9541.50
22,18,RFK,4068,36517.31,3289,28935.81,779,7581.50
23,18,RFK,3142,28712.53,2470,21816.03,672,6896.50
0,19,RFK,1795,16919.73,1381,12172.73,414,4747.00
1,19,RFK,1115,12251.76,793,8101.26,322,4150.50
2,19,RFK,843,9989.07,584,6530.07,259,3459.00
3,19,RFK,1041,14122.82,732,8938.32,309,5184.50
4,19,RFK,1986,23089.11,1463,15096.11,523,7993.00
5,19,RFK,5501,57519.35,4394,41976.85,1107,15542.50
6,19,RFK,9468,94570.47,7583,69426.97,1885,25143.50
7,19,RFK,9963,99733.86,7935,72982.86,2028,26751.00
8,19,RFK,9418,96253.59,7305,68365.09,2113,27888.50
9,19,RFK,8746,90731.57,6813,64629.07,1933,26102.50
10,19,RFK,8416,88493.18,6562,63256.18,1854,25237.00
11,19,RFK,7962,82837.73,6158,58810.73,1804,24027.00
12,19,RFK,7205,75935.57,5499,53203.07,1706,22732.50
13,19,RFK,7293,76575.14,5532,52529.64,1761,24045.50
14,19,RFK,7587,76977.71,5899,55766.21,1688,21211.50
15,19,RFK,7570,75987.99,5846,54095.49,1724,21892.50
16,19,RFK,6893,66811.60,5506,49835.60,1387,16976.00
17,19,RFK,7663,71400.51,6206,54991.01,1457,16409.50
18,19,RFK,7715,70563.99,6274,55442.49,1441,15121.50
19,19,RFK,6541,60379.32,5287,47399.82,1254,12979.50
20,19,RFK,5338,48944.54,4262,37572.54,1076,11372.00
21,19,RFK,4354,40923.85,3466,30980.35,888,9943.50
22,19,RFK,3633,34772.99,2854,25965.99,779,8807.00
23,19,RFK,2723,25847.83,2097,18975.83,626,6872.00
0,20,RFK,1737,17717.34,1321,12595.84,416,5121.50
1,20,RFK,1009,11707.33,723,7373.58,286,4333.75
2,20,RFK,864,11091.66,605,7125.66,259,3966.00
3,20,RFK,983,13211.40,692,8432.40,291,4779.00
4,20,RFK,1930,23858.17,1436,15974.17,494,7884.00
5,20,RFK,5257,56423.20,4166,40263.20,1091,16160.00
6,20,RFK,9288,94795.02,7356,68261.02,1932,26534.00
7,20,RFK,9578,96297.43,7596,69600.93,1982,26696.50
8,20,RFK,8957,92012.99,6968,65540.99,1989,26472.00
9,20,RFK,7861,83854.91,6105,59280.41,1756,24574.50
10,20,RFK,7690,79541.07,6030,57174.07,1660,22367.00
11,20,RFK,7627,79134.74,5913,56205.24,1714,22929.50
12,20,RFK,7394,77887.47,5648,53995.97,1746,23891.50
13,20,RFK,7348,75818.59,5709,53970.09,1639,21848.50
14,20,RFK,8552,86810.44,6671,62469.44,1881,24341.00
15,20,RFK,8706,85293.91,6873,62657.41,1833,22636.50
16,20,RFK,8712,82156.54,7079,63403.54,1633,18753.00
17,20,RFK,7742,72092.70,6311,56072.20,1431,16020.50
18,20,RFK,7803,71948.57,6420,57087.57,1383,14861.00
19,20,RFK,7850,71865.45,6388,56500.45,1462,15365.00
20,20,RFK,6491,59518.14,5229,46155.64,1262,13362.50
21,20,RFK,5633,51603.61,4506,39620.61,1127,11983.00
22,20,RFK,4828,45279.44,3787,33756.94,1041,11522.50
23,20,RFK,3701,34818.75,2936,26576.25,765,8242.50
0,21,RFK,2111,21136.89,1621,15213.89,490,5923.00
1,21,RFK,1137,12556.46,819,8297.46,318,4259.00
2,21,RFK,1001,12997.09,697,8329.09,304,4668.00
3,21,RFK,1048,13597.82,746,8897.32,302,4700.50
4,21,RFK,1988,24012.34,1507,16308.34,481,7704.00
5,21,RFK,5301,57877.49,4187,40654.99,1114,17222.50
6,21,RFK,9291,94499.27,7367,68375.27,1924,26124.00
7,21,RFK,9588,97027.65,7600,70900.15,1988,26127.50
8,21,RFK,8414,86005.72,6561,61448.22,1853,24557.50
9,21,RFK,8206,86455.24,6394,61257.74,1812,25197.50
10,21,RFK,7766,79996.42,6127,58101.92,1639,21894.50
11,21,RFK,7663,79347.33,6003,56651.33,1660,22696.00
12,21,RFK,7499,77481.71,5796,55079.71,1703,22402.00
13,21,RFK,8020,80537.72,6239,58250.72,1781,22287.00
14,21,RFK,8422,83289.84,6613,60961.84,1809,22328.00
15,21,RFK,8549,82301.33,6722,60889.33,1827,21412.00
16,21,RFK,8018,75878.87,6326,56676.37,1692,19202.50
17,21,RFK,7538,69410.57,5999,52929.57,1539,16481.00
18,21,RFK,7440,68290.05,5970,53231.55,1470,15058.50
19,21,RFK,6726,60505.28,5370,46917.78,1356,13587.50
20,21,RFK,6158,55190.85,4878,42471.85,1280,12719.00
21,21,RFK,5509,48962.33,4321,37399.83,1188,11562.50
22,21,RFK,4536,41179.81,3519,30851.81,1017,10328.00
23,21,RFK,3694,33187.07,2897,25425.07,797,7762.00
0,22,RFK,2497,23475.03,1918,17366.03,579,6109.00
1,22,RFK,1533,14547.71,1099,9711.71,434,4836.00
2,22,RFK,1167,11274.83,870,8022.83,297,3252.00
3,22,RFK,1165,11042.22,858,7701.22,307,3341.00
4,22,RFK,1726,15285.20,1313,10767.70,413,4517.50
5,22,RFK,1909,17303.00,1513,12899.00,396,4404.00
6,22,RFK,2897,26056.37,2352,20182.37,545,5874.00
7,22,RFK,3297,30211.45,2650,23319.45,647,6892.00
8,22,RFK,3751,33710.56,2990,25965.06,761,7745.50
9,22,RFK,4446,39890.71,3602,31441.21,844,8449.50
10,22,RFK,5885,51554.86,4819,41450.86,1066,10104.00
11,22,RFK,7592,66430.53,6191,53278.03,1401,13152.50
12,22,RFK,8309,72023.89,6796,57948.39,1513,14075.50
13,22,RFK,8547,73517.23,6975,59301.73,1572,14215.50
14,22,RFK,8919,76962.46,7253,61721.46,1666,15241.00
15,22,RFK,8209,70759.30,6570,56109.80,1639,14649.50
16,22,RFK,6937,59913.61,5491,46917.11,1446,12996.50
17,22,RFK,6096,52848.55,4883,41828.55,1213,11020.00
18,22,RFK,6343,54857.84,5070,43396.34,1273,11461.50
19,22,RFK,6875,59342.49,5640,48172.99,1235,11169.50
20,22,RFK,8017,69247.44,6680,57248.94,1337,11998.50
21,22,RFK,7735,66604.02,6373,54402.52,1362,12201.50
22,22,RFK,7752,66852.77,6284,53649.77,1468,13203.00
23,22,RFK,6740,58337.42,5333,45745.92,1407,12591.50
0,23,RFK,3645,32528.67,2822,24736.67,823,7792.00
1,23,RFK,2176,19822.62,1683,14910.12,493,4912.50
2,23,RFK,1352,12719.53,1006,9059.03,346,3660.50
3,23,RFK,1153,12103.78,871,8630.78,282,3473.00
4,23,RFK,1351,14029.02,1053,10424.02,298,3605.00
5,23,RFK,2595,26536.95,2062,19719.45,533,6817.50
6,23,RFK,4514,45166.48,3554,33542.98,960,11623.50
7,23,RFK,4637,47095.89,3647,34245.39,990,12850.50
8,23,RFK,4786,48887.80,3693,34816.80,1093,14071.00
9,23,RFK,5221,52403.54,4054,37762.54,1167,14641.00
10,23,RFK,6239,61034.82,4892,45159.82,1347,15875.00
11,23,RFK,6520,62760.68,5102,46514.68,1418,16246.00
12,23,RFK,7041,66072.10,5563,49890.10,1478,16182.00
13,23,RFK,7076,66005.63,5616,50183.63,1460,15822.00
14,23,RFK,7465,68737.56,5946,52485.56,1519,16252.00
15,23,RFK,7507,67785.51,5929,51760.51,1578,16025.00
16,23,RFK,6849,62260.42,5398,47482.42,1451,14778.00
17,23,RFK,6474,58357.17,5147,44889.67,1327,13467.50
18,23,RFK,5873,52506.03,4600,40143.03,1273,12363.00
19,23,RFK,4869,43536.04,3803,33252.54,1066,10283.50
20,23,RFK,4516,40247.21,3528,30517.71,988,9729.50
21,23,RFK,4133,36885.39,3242,27961.89,891,8923.50
22,23,RFK,3653,32879.47,2870,25072.97,783,7806.50
23,23,RFK,3150,28606.98,2459,21700.98,691,6906.00
0,24,RFK,2163,19801.95,1688,14966.45,475,4835.50
1,24,RFK,1516,14553.40,1130,10248.40,386,4305.00
2,24,RFK,1190,11971.78,870,8371.28,320,3600.50
3,24,RFK,1181,12173.56,880,8309.56,301,3864.00
4,24,RFK,1606,15820.41,1202,11159.41,404,4661.00
5,24,RFK,1950,19868.08,1515,14140.08,435,5728.00
6,24,RFK,3272,31937.89,2570,23752.39,702,8185.50
7,24,RFK,4027,38892.75,3128,28889.25,899,10003.50
8,24,RFK,4359,40892.32,3417,30652.32,942,10240.00
9,24,RFK,5454,50734.96,4366,39117.46,1088,11617.50
10,24,RFK,5858,53489.77,4671,40945.77,1187,12544.00
11,24,RFK,6924,62521.33,5537,48517.83,1387,14003.50
12,24,RFK,7328,65685.52,5808,50763.02,1520,14922.50
13,24,RFK,7937,71057.16,6253,54473.16,1684,16584.00
14,24,RFK,8494,75128.07,6791,58716.07,1703,16412.00
15,24,RFK,7992,70380.21,6472,56033.21,1520,14347.00
16,24,RFK,8160,71746.69,6632,57148.19,1528,14598.50
17,24,RFK,7957,69217.18,6541,56359.68,1416,12857.50
18,24,RFK,7737,67357.17,6301,54071.67,1436,13285.50
19,24,RFK,7236,62924.07,5900,50919.07,1336,12005.00
20,24,RFK,6251,54614.60,5017,43060.60,1234,11554.00
21,24,RFK,5859,51149.33,4742,40750.83,1117,10398.50
22,24,RFK,5037,44017.28,4055,34905.78,982,9111.50
23,24,RFK,4438,38619.05,3611,31163.05,827,7456.00
0,25,RFK,3247,28578.21,2582,22384.21,665,6194.00
1,25,RFK,2136,18965.82,1645,14354.32,491,4611.50
2,25,RFK,1640,14954.26,1223,10900.76,417,4053.50
3,25,RFK,1511,14327.54,1113,10202.04,398,4125.50
4,25,RFK,1718,15416.18,1268,11054.18,450,4362.00
5,25,RFK,1987,17917.96,1551,13524.96,436,4393.00
6,25,RFK,2676,24348.36,2165,19052.36,511,5296.00
7,25,RFK,3195,28902.82,2552,22390.32,643,6512.50
8,25,RFK,4064,36496.44,3267,28582.94,797,7913.50
9,25,RFK,5738,50838.86,4719,41178.36,1019,9660.50
10,25,RFK,7412,64673.40,6034,52025.40,1378,12648.00
11,25,RFK,7735,67207.54,6284,53938.54,1451,13269.00
12,25,RFK,8448,73318.70,6923,59359.70,1525,13959.00
13,25,RFK,8791,75899.16,7189,61419.66,1602,14479.50
14,25,RFK,9014,78370.94,7352,62881.94,1662,15489.00
15,25,RFK,8999,78128.02,7424,63621.52,1575,14506.50
16,25,RFK,8671,75226.48,7124,61016.98,1547,14209.50
17,25,RFK,8607,74410.70,7092,60805.70,1515,13605.00
18,25,RFK,8651,75148.81,7085,60876.81,1566,14272.00
19,25,RFK,7736,67757.78,6267,54006.78,1469,13751.00
20,25,RFK,6472,57084.79,5251,45353.29,1221,11731.50
21,25,RFK,5498,48988.20,4471,38998.70,1027,9989.50
22,25,RFK,4664,41856.31,3766,32947.81,898,8908.50
23,25,RFK,3407,30752.40,2701,23805.90,706,6946.50
0,11,LIN,1113,16863.50,1012,15215.00,101,1648.50
1,11,LIN,785,12732.50,715,11541.50,70,1191.00
2,11,LIN,592,10055.50,541,9159.00,51,896.50
3,11,LIN,588,9861.50,544,9042.50,44,819.00
4,11,LIN,510,7905.00,464,7165.50,46,739.50
5,11,LIN,778,12007.50,732,11212.50,46,795.00
6,11,LIN,1246,18177.50,1153,16771.00,93,1406.50
7,11,LIN,1502,21291.00,1413,19828.50,89,1462.50
8,11,LIN,1938,27012.00,1788,24533.00,150,2479.00
9,11,LIN,2567,34776.50,2418,32584.00,149,2192.50
10,11,LIN,2820,37754.00,2639,34724.50,181,3029.50
11,11,LIN,2821,39945.50,2644,37343.00,177,2602.50
12,11,LIN,3089,43986.50,2827,39932.50,262,4054.00
13,11,LIN,2854,40563.00,2691,37998.50,163,2564.50
14,11,LIN,2897,41936.00,2655,38139.00,242,3797.00
15,11,LIN,2951,42954.50,2739,39678.00,212,3276.50
16,11,LIN,2972,43561.00,2758,40214.50,214,3346.50
17,11,LIN,2573,37749.00,2345,34322.00,228,3427.00
18,11,LIN,2941,43457.00,2702,39738.50,239,3718.50
19,11,LIN,2940,44597.00,2712,40907.50,228,3689.50
20,11,LIN,2331,36062.50,2106,32216.50,225,3846.00
21,11,LIN,1649,25527.00,1497,22981.50,152,2545.50
22,11,LIN,1337,21156.50,1210,19061.50,127,2095.00
23,11,LIN,931,15594.00,837,13716.00,94,1878.00
0,12,LIN,650,11371.50,596,10401.50,54,970.00
1,12,LIN,462,9782.00,410,8513.50,52,1268.50
2,12,LIN,357,8515.00,314,7201.50,43,1313.50
3,12,LIN,440,13303.00,405,11996.00,35,1307.00
4,12,LIN,856,22585.50,766,19366.50,90,3219.00
5,12,LIN,2841,55771.50,2660,51166.00,181,4605.50
6,12,LIN,3984,72091.00,3721,67040.00,263,5051.00
7,12,LIN,3806,65311.50,3552,60398.50,254,4913.00
8,12,LIN,3229,53303.00,3010,49174.00,219,4129.00
9,12,LIN,2662,43159.50,2511,40609.00,151,2550.50
10,12,LIN,2454,37544.50,2275,34082.50,179,3462.00
11,12,LIN,2260,34414.50,2083,31263.00,177,3151.50
12,12,LIN,2080,31720.00,1934,28912.50,146,2807.50
13,12,LIN,2006,31686.50,1852,28824.00,154,2862.50
14,12,LIN,2168,32412.50,2006,29442.50,162,2970.00
15,12,LIN,2098,31852.50,1971,29733.00,127,2119.50
16,12,LIN,1839,28186.00,1717,26084.00,122,2102.00
17,12,LIN,1511,23365.00,1431,21983.00,80,1382.00
18,12,LIN,1809,28013.00,1712,26330.50,97,1682.50
19,12,LIN,1647,27368.50,1522,25231.50,125,2137.00
20,12,LIN,1582,25643.50,1451,23252.50,131,2391.00
21,12,LIN,1544,25309.00,1411,22743.00,133,2566.00
22,12,LIN,1349,23362.00,1224,21028.00,125,2334.00
23,12,LIN,1116,18121.50,1022,16560.50,94,1561.00
0,13,LIN,743,13766.50,674,12207.50,69,1559.00
1,13,LIN,454,10272.00,412,9039.00,42,1233.00
2,13,LIN,384,9828.00,348,8596.50,36,1231.50
3,13,LIN,500,14806.00,445,13162.00,55,1644.00
4,13,LIN,970,24448.50,876,21712.50,94,2736.00
5,13,LIN,3155,63773.50,2949,59239.00,206,4534.50
6,13,LIN,4317,77671.00,4025,71607.50,292,6063.50
7,13,LIN,3955,69093.00,3688,64086.00,267,5007.00
8,13,LIN,3159,53406.50,2948,49338.00,211,4068.50
9,13,LIN,3254,53929.50,3050,50211.00,204,3718.50
10,13,LIN,3064,48759.00,2850,44878.50,214,3880.50
11,13,LIN,2982,46955.00,2768,42828.00,214,4127.00
12,13,LIN,2114,33403.00,1974,30781.00,140,2622.00
13,13,LIN,1969,30414.00,1831,28103.50,138,2310.50
14,13,LIN,2359,37139.00,2169,33671.50,190,3467.50
15,13,LIN,2158,32745.50,2007,30339.50,151,2406.00
16,13,LIN,1878,29725.50,1769,27702.00,109,2023.50
17,13,LIN,1575,24724.00,1473,23071.50,102,1652.50
18,13,LIN,1830,28749.00,1721,26864.50,109,1884.50
19,13,LIN,1698,27600.00,1580,25567.50,118,2032.50
20,13,LIN,1610,25910.50,1482,23536.50,128,2374.00
21,13,LIN,1637,27075.50,1496,24356.00,141,2719.50
22,13,LIN,1624,27669.00,1482,25171.00,142,2498.00
23,13,LIN,1255,21032.50,1163,19384.00,92,1648.50
0,14,LIN,783,14993.00,699,13201.00,84,1792.00
1,14,LIN,522,10555.00,465,9324.00,57,1231.00
2,14,LIN,424,10722.50,378,9123.50,46,1599.00
3,14,LIN,538,15791.50,495,14488.50,43,1303.00
4,14,LIN,1031,25817.00,938,22934.00,93,2883.00
5,14,LIN,3388,67795.00,3164,62315.00,224,5480.00
6,14,LIN,4319,77772.00,4024,71843.00,295,5929.00
7,14,LIN,4050,70398.00,3778,65337.00,272,5061.00
8,14,LIN,3379,57238.50,3133,52820.00,246,4418.50
9,14,LIN,3318,56014.50,3078,51593.00,240,4421.50
10,14,LIN,3081,47599.50,2904,44573.50,177,3026.00
11,14,LIN,2622,40234.50,2439,36795.00,183,3439.50
12,14,LIN,2404,37370.50,2242,34204.50,162,3166.00
13,14,LIN,2146,33559.00,2003,31135.00,143,2424.00
14,14,LIN,2265,35068.50,2120,32493.00,145,2575.50
15,14,LIN,2144,32818.50,2017,30452.50,127,2366.00
16,14,LIN,1879,30054.00,1742,27757.50,137,2296.50
17,14,LIN,1688,26162.50,1581,24394.00,107,1768.50
18,14,LIN,2132,33325.00,1999,31050.50,133,2274.50
19,14,LIN,2009,32992.00,1849,29899.00,160,3093.00
20,14,LIN,1700,27180.00,1568,24890.50,132,2289.50
21,14,LIN,1875,30909.50,1741,28521.50,134,2388.00
22,14,LIN,1800,30850.50,1671,28275.50,129,2575.00
23,14,LIN,1447,23956.50,1343,22126.50,104,1830.00
0,15,LIN,910,16383.50,815,14399.00,95,1984.50
1,15,LIN,592,12496.00,539,10991.00,53,1505.00
2,15,LIN,487,11352.00,427,9743.50,60,1608.50
3,15,LIN,499,14403.50,440,12662.50,59,1741.00
4,15,LIN,1019,25667.50,925,22229.00,94,3438.50
5,15,LIN,3185,64318.00,2955,58640.00,230,5678.00
6,15,LIN,4619,83693.00,4351,78321.00,268,5372.00
7,15,LIN,3931,67699.00,3703,63283.00,228,4416.00
8,15,LIN,3731,64170.00,3493,59604.50,238,4565.50
9,15,LIN,3491,60387.00,3282,56246.00,209,4141.00
10,15,LIN,2631,41796.50,2439,38293.00,192,3503.50
11,15,LIN,2320,35814.50,2141,32362.00,179,3452.50
12,15,LIN,2028,31463.00,1861,28364.50,167,3098.50
13,15,LIN,2040,32308.00,1875,29317.50,165,2990.50
14,15,LIN,1746,26633.50,1597,23760.00,149,2873.50
15,15,LIN,1022,15976.00,937,14105.50,85,1870.50
16,15,LIN,422,6931.00,382,6031.00,40,900.00
17,15,LIN,429,7224.00,387,6225.00,42,999.00
18,15,LIN,306,4586.00,273,4062.00,33,524.00
19,15,LIN,596,9588.50,548,8725.00,48,863.50
20,15,LIN,804,12376.00,728,10913.50,76,1462.50
21,15,LIN,1114,17565.50,996,15419.00,118,2146.50
22,15,LIN,1234,19279.00,1128,17280.50,106,1998.50
23,15,LIN,1462,24352.00,1322,21626.50,140,2725.50
0,16,LIN,996,18540.00,890,16234.00,106,2306.00
1,16,LIN,783,14309.50,701,12595.50,82,1714.00
2,16,LIN,677,14143.50,619,12699.50,58,1444.00
3,16,LIN,625,13891.50,573,12695.00,52,1196.50
4,16,LIN,827,18589.50,758,16648.50,69,1941.00
5,16,LIN,2426,46965.00,2258,42932.00,168,4033.00
6,16,LIN,3637,67890.00,3388,61842.00,249,6048.00
7,16,LIN,3267,59585.00,3008,53606.50,259,5978.50
8,16,LIN,2891,52943.50,2688,48529.00,203,4414.50
9,16,LIN,2411,43063.50,2222,39020.00,189,4043.50
10,16,LIN,2381,38909.00,2190,35484.00,191,3425.00
11,16,LIN,2217,34381.00,2058,31691.50,159,2689.50
12,16,LIN,2185,34200.00,2008,31044.50,177,3155.50
13,16,LIN,2299,35228.00,2133,32334.00,166,2894.00
14,16,LIN,2338,35229.00,2193,32789.50,145,2439.50
15,16,LIN,2009,30106.00,1874,27926.00,135,2180.00
16,16,LIN,1987,31443.50,1863,29070.00,124,2373.50
17,16,LIN,1816,27961.00,1700,25979.50,116,1981.50
18,16,LIN,2070,31506.50,1940,29250.50,130,2256.00
19,16,LIN,1898,30589.50,1759,28233.50,139,2356.00
20,16,LIN,1696,25950.00,1571,24002.00,125,1948.00
21,16,LIN,1660,26007.00,1511,23387.50,149,2619.50
22,16,LIN,1500,25434.00,1365,22731.00,135,2703.00
23,16,LIN,1410,23615.50,1274,21166.50,136,2449.00
0,17,LIN,1017,16888.50,930,15324.00,87,1564.50
1,17,LIN,894,16211.00,806,14456.50,88,1754.50
2,17,LIN,642,12782.00,563,11019.50,79,1762.50
3,17,LIN,608,13009.00,539,11144.00,69,1865.00
4,17,LIN,615,12581.00,560,11123.00,55,1458.00
5,17,LIN,1528,28731.00,1424,26084.00,104,2647.00
6,17,LIN,2225,38063.00,2078,35122.50,147,2940.50
7,17,LIN,2028,34044.50,1907,31793.50,121,2251.00
8,17,LIN,2421,36476.00,2253,33305.00,168,3171.00
9,17,LIN,2709,38250.00,2542,35661.50,167,2588.50
10,17,LIN,2838,39582.00,2655,36611.50,183,2970.50
11,17,LIN,3082,44395.50,2908,41623.50,174,2772.00
12,17,LIN,2786,39933.50,2607,37190.00,179,2743.50
13,17,LIN,2732,39578.00,2539,36400.50,193,3177.50
14,17,LIN,2444,35375.00,2271,32585.50,173,2789.50
15,17,LIN,2487,35975.50,2333,33500.50,154,2475.00
16,17,LIN,2740,39261.00,2576,36777.00,164,2484.00
17,17,LIN,3124,45030.50,2928,41994.00,196,3036.50
18,17,LIN,3141,45943.00,2907,42280.00,234,3663.00
19,17,LIN,2766,41223.00,2573,38195.00,193,3028.00
20,17,LIN,1847,28545.00,1709,26156.00,138,2389.00
21,17,LIN,1710,25117.00,1559,22788.50,151,2328.50
22,17,LIN,1796,27019.50,1638,24303.50,158,2716.00
23,17,LIN,1463,21343.50,1339,19492.50,124,1851.00
0,18,LIN,1148,18395.50,1041,16209.50,107,2186.00
1,18,LIN,982,15809.50,887,14262.50,95,1547.00
2,18,LIN,686,10877.50,626,9946.00,60,931.50
3,18,LIN,515,9108.50,461,8058.00,54,1050.50
4,18,LIN,480,7575.00,451,7014.00,29,561.00
5,18,LIN,799,12062.50,746,11097.50,53,965.00
6,18,LIN,1300,18611.50,1224,17358.00,76,1253.50
7,18,LIN,1465,21034.50,1377,19510.00,88,1524.50
8,18,LIN,1640,22809.50,1537,21211.00,103,1598.50
9,18,LIN,2374,32819.50,2216,30354.50,158,2465.00
10,18,LIN,2719,36286.50,2567,34133.00,152,2153.50
11,18,LIN,2959,42181.50,2764,39279.00,195,2902.50
12,18,LIN,3156,45166.00,2971,42225.00,185,2941.00
13,18,LIN,2931,41997.00,2745,39111.50,186,2885.50
14,18,LIN,2882,41598.00,2703,38841.00,179,2757.00
15,18,LIN,3082,45162.50,2871,41891.50,211,3271.00
16,18,LIN,3034,44623.00,2801,41004.50,233,3618.50
17,18,LIN,2874,42416.50,2626,38490.00,248,3926.50
18,18,LIN,2871,42737.50,2665,39632.00,206,3105.50
19,18,LIN,2238,34270.00,2086,31899.00,152,2371.00
20,18,LIN,1864,29633.50,1726,27172.00,138,2461.50
21,18,LIN,1606,25176.00,1476,22766.50,130,2409.50
22,18,LIN,1363,23103.00,1236,20563.50,127,2539.50
23,18,LIN,1022,17318.00,940,15654.50,82,1663.50
0,19,LIN,640,11828.00,580,10529.00,60,1299.00
1,19,LIN,374,7670.00,331,6599.50,43,1070.50
2,19,LIN,377,8846.00,348,7940.00,29,906.00
3,19,LIN,490,13093.50,441,11862.00,49,1231.50
4,19,LIN,978,23646.00,876,20961.00,102,2685.00
5,19,LIN,3316,62488.00,3118,58367.00,198,4121.00
6,19,LIN,4344,78748.50,4059,72966.50,285,5782.00
7,19,LIN,4079,69724.50,3830,65306.00,249,4418.50
8,19,LIN,3826,65813.00,3559,60575.00,267,5238.00
9,19,LIN,3519,59140.50,3285,54767.50,234,4373.00
10,19,LIN,2707,42172.00,2503,38559.00,204,3613.00
11,19,LIN,2423,37837.00,2241,34795.00,182,3042.00
12,19,LIN,2106,33506.00,1931,30153.50,175,3352.50
13,19,LIN,1998,31647.50,1825,28614.00,173,3033.50
14,19,LIN,2116,32365.50,1978,29954.50,138,2411.00
15,19,LIN,2063,31685.50,1928,29347.50,135,2338.00
16,19,LIN,1689,27203.50,1583,25398.00,106,1805.50
17,19,LIN,1352,21232.00,1268,19665.00,84,1567.00
18,19,LIN,1737,27427.00,1636,25764.50,101,1662.50
19,19,LIN,1744,28389.00,1613,25938.00,131,2451.00
20,19,LIN,1559,26761.50,1425,23980.50,134,2781.00
21,19,LIN,1576,26875.00,1440,24439.50,136,2435.50
22,19,LIN,1478,25707.50,1330,22994.50,148,2713.00
23,19,LIN,1090,19340.00,995,17516.00,95,1824.00
0,20,LIN,723,13939.00,645,12236.00,78,1703.00
1,20,LIN,472,10540.50,422,8946.00,50,1594.50
2,20,LIN,402,10154.50,354,8689.00,48,1465.50
3,20,LIN,538,15937.00,488,14028.50,50,1908.50
4,20,LIN,1046,27486.50,941,23519.00,105,3967.50
5,20,LIN,3276,66222.00,3070,61113.00,206,5109.00
6,20,LIN,4424,80022.50,4159,74469.00,265,5553.50
7,20,LIN,2768,46005.50,2573,42187.50,195,3818.00
8,20,LIN,2436,43029.00,2270,39883.00,166,3146.00
9,20,LIN,3569,65200.00,3294,59353.50,275,5846.50
10,20,LIN,3062,49467.50,2828,45063.50,234,4404.00
11,20,LIN,2882,46656.50,2670,42858.50,212,3798.00
12,20,LIN,2196,35123.00,2027,32077.00,169,3046.00
13,20,LIN,2099,33211.50,1934,29977.00,165,3234.50
14,20,LIN,2544,38922.50,2339,35161.50,205,3761.00
15,20,LIN,1875,28863.50,1752,26864.00,123,1999.50
16,20,LIN,1974,30968.50,1846,28878.50,128,2090.00
17,20,LIN,1726,26789.50,1612,24846.50,114,1943.00
18,20,LIN,1864,28629.50,1743,26596.00,121,2033.50
19,20,LIN,1777,28996.00,1644,26736.50,133,2259.50
20,20,LIN,1844,30298.50,1712,27804.00,132,2494.50
21,20,LIN,1824,30661.00,1681,28108.00,143,2553.00
22,20,LIN,1763,30050.00,1621,27300.50,142,2749.50
23,20,LIN,1463,25046.00,1364,23168.50,99,1877.50
0,21,LIN,948,17169.50,877,15659.00,71,1510.50
1,21,LIN,585,13710.50,516,11912.50,69,1798.00
2,21,LIN,465,11195.00,418,9711.00,47,1484.00
3,21,LIN,572,16524.00,515,14560.00,57,1964.00
4,21,LIN,1026,26474.50,929,23224.00,97,3250.50
5,21,LIN,3275,66207.50,3047,60554.00,228,5653.50
6,21,LIN,4285,80290.00,4006,74391.50,279,5898.50
7,21,LIN,3731,66580.00,3510,62323.00,221,4257.00
8,21,LIN,3509,61654.00,3269,56971.50,240,4682.50
9,21,LIN,2828,48720.00,2626,44906.00,202,3814.00
10,21,LIN,2582,41409.00,2380,37324.00,202,4085.00
11,21,LIN,2360,36476.00,2172,33322.50,188,3153.50
12,21,LIN,2276,35328.00,2096,32253.50,180,3074.50
13,21,LIN,2086,30884.50,1923,28140.50,163,2744.00
14,21,LIN,1627,24563.00,1509,22634.50,118,1928.50
15,21,LIN,1946,29515.00,1827,27405.50,119,2109.50
16,21,LIN,1806,27881.50,1696,25992.00,110,1889.50
17,21,LIN,1530,23390.00,1445,22032.50,85,1357.50
18,21,LIN,1846,29049.50,1737,27137.00,109,1912.50
19,21,LIN,1702,27682.50,1549,24954.00,153,2728.50
20,21,LIN,1549,24316.00,1406,21688.00,143,2628.00
21,21,LIN,1129,17524.50,1031,15603.50,98,1921.00
22,21,LIN,1528,25286.50,1372,22291.50,156,2995.00
23,21,LIN,1144,18748.00,1052,17063.50,92,1684.50
0,22,LIN,730,12535.00,662,11212.50,68,1322.50
1,22,LIN,433,8300.00,392,7449.00,41,851.00
2,22,LIN,412,7709.00,369,6810.50,43,898.50
3,22,LIN,391,7399.50,352,6654.00,39,745.50
4,22,LIN,573,8859.50,528,8043.00,45,816.50
5,22,LIN,1158,16728.00,1078,15379.50,80,1348.50
6,22,LIN,1329,19785.50,1243,18498.00,86,1287.50
7,22,LIN,1360,20647.00,1290,19461.50,70,1185.50
8,22,LIN,1190,17204.00,1118,16038.50,72,1165.50
9,22,LIN,1049,15430.00,979,14324.50,70,1105.50
10,22,LIN,1106,15265.00,1020,13958.50,86,1306.50
11,22,LIN,1577,21579.50,1470,19989.50,107,1590.00
12,22,LIN,2037,27213.50,1900,25144.50,137,2069.00
13,22,LIN,2291,30538.50,2145,28353.00,146,2185.50
14,22,LIN,2177,28999.00,2040,27047.50,137,1951.50
15,22,LIN,2013,27523.50,1852,25067.50,161,2456.00
16,22,LIN,1567,22890.00,1460,21149.00,107,1741.00
17,22,LIN,1557,23304.00,1418,20898.50,139,2405.50
18,22,LIN,1542,22856.50,1404,20581.00,138,2275.50
19,22,LIN,1910,28176.50,1779,26215.00,131,1961.50
20,22,LIN,2307,32746.00,2166,30542.50,141,2203.50
21,22,LIN,3058,43766.00,2834,40319.50,224,3446.50
22,22,LIN,3044,44003.50,2792,40109.00,252,3894.50
23,22,LIN,1784,26073.00,1623,23589.00,161,2484.00
0,23,LIN,769,12500.00,696,11193.00,73,1307.00
1,23,LIN,480,8521.50,430,7677.00,50,844.50
2,23,LIN,341,6791.00,311,6064.50,30,726.50
3,23,LIN,375,8936.00,345,8163.00,30,773.00
4,23,LIN,558,13810.00,514,12632.00,44,1178.00
5,23,LIN,1363,27769.50,1268,25577.00,95,2192.50
6,23,LIN,2077,40128.00,1903,36264.50,174,3863.50
7,23,LIN,1880,33334.50,1748,30964.50,132,2370.00
8,23,LIN,1733,29187.50,1598,26499.50,135,2688.00
9,23,LIN,1886,30264.00,1765,28040.00,121,2224.00
10,23,LIN,2093,29581.50,1941,27376.00,152,2205.50
11,23,LIN,2411,33201.00,2236,30461.00,175,2740.00
12,23,LIN,2415,33106.50,2250,30576.50,165,2530.00
13,23,LIN,2323,31853.50,2164,29525.50,159,2328.00
14,23,LIN,2341,32809.50,2175,30209.50,166,2600.00
15,23,LIN,2247,32342.00,2094,29833.00,153,2509.00
16,23,LIN,2222,33507.50,2060,30822.00,162,2685.50
17,23,LIN,2122,31561.00,1967,29095.00,155,2466.00
18,23,LIN,2142,32021.00,1995,29711.00,147,2310.00
19,23,LIN,1769,27521.00,1619,25042.50,150,2478.50
20,23,LIN,1721,26321.50,1567,23524.50,154,2797.00
21,23,LIN,1501,23598.00,1361,21246.00,140,2352.00
22,23,LIN,1393,22892.00,1287,21005.00,106,1887.00
23,23,LIN,1032,16413.50,940,14852.00,92,1561.50
0,24,LIN,726,12860.50,631,10816.50,95,2044.00
1,24,LIN,426,7952.00,372,6757.00,54,1195.00
2,24,LIN,366,7662.00,331,6859.50,35,802.50
3,24,LIN,386,8901.50,338,7695.00,48,1206.50
4,24,LIN,481,9069.50,451,8291.00,30,778.50
5,24,LIN,1037,19703.00,973,18104.00,64,1599.00
6,24,LIN,1442,25446.50,1351,23371.00,91,2075.50
7,24,LIN,1484,23300.50,1386,21446.00,98,1854.50
8,24,LIN,1666,25335.50,1546,23034.50,120,2301.00
9,24,LIN,2089,29148.00,1948,26856.50,141,2291.50
10,24,LIN,2393,32397.00,2241,30054.50,152,2342.50
11,24,LIN,2901,41335.50,2721,38557.50,180,2778.00
12,24,LIN,2858,41321.50,2675,38459.50,183,2862.00
13,24,LIN,2517,36032.00,2356,33528.50,161,2503.50
14,24,LIN,2369,34174.50,2222,31912.00,147,2262.50
15,24,LIN,2760,39924.00,2568,36927.00,192,2997.00
16,24,LIN,2923,42234.50,2739,39332.00,184,2902.50
17,24,LIN,2220,32218.50,2068,29808.00,152,2410.50
18,24,LIN,2748,41069.50,2560,38124.50,188,2945.00
19,24,LIN,2460,36680.50,2288,33901.00,172,2779.50
20,24,LIN,2243,34081.50,2058,31129.50,185,2952.00
21,24,LIN,1840,27192.50,1694,24785.50,146,2407.00
22,24,LIN,1654,24073.00,1511,21870.50,143,2202.50
23,24,LIN,1444,21541.50,1325,19585.50,119,1956.00
0,25,LIN,1033,15932.00,920,13817.00,113,2115.00
1,25,LIN,777,13003.00,707,11863.50,70,1139.50
2,25,LIN,462,7756.50,423,7149.00,39,607.50
3,25,LIN,377,6440.50,337,5651.00,40,789.50
4,25,LIN,451,7090.00,425,6482.50,26,607.50
5,25,LIN,733,11125.00,686,10362.00,47,763.00
6,25,LIN,1146,16752.00,1070,15485.00,76,1267.00
7,25,LIN,1307,18991.50,1217,17513.50,90,1478.00
8,25,LIN,1759,23996.00,1661,22506.00,98,1490.00
9,25,LIN,2413,32212.50,2248,29756.50,165,2456.00
10,25,LIN,2754,36902.50,2565,34256.00,189,2646.50
11,25,LIN,2894,41413.50,2718,38743.50,176,2670.00
12,25,LIN,2498,35669.50,2319,32985.50,179,2684.00
13,25,LIN,2586,37246.50,2419,34549.00,167,2697.50
14,25,LIN,2735,39462.50,2541,36395.00,194,3067.50
15,25,LIN,2727,39756.50,2510,36226.50,217,3530.00
16,25,LIN,3004,43843.00,2744,39920.00,260,3923.00
17,25,LIN,2817,41474.00,2558,37462.00,259,4012.00
18,25,LIN,2881,42457.50,2638,38593.00,243,3864.50
19,25,LIN,2833,42894.50,2605,39183.50,228,3711.00
20,25,LIN,2784,42508.00,2542,38560.50,242,3947.50
21,25,LIN,1967,30256.50,1783,27161.50,184,3095.00
22,25,LIN,1602,25532.00,1463,23126.50,139,2405.50
23,25,LIN,1197,19468.00,1089,17461.00,108,2007.00
0,11,HOL,1201,17272.50,1088,15531.00,113,1741.50
1,11,HOL,1028,15230.50,946,13979.50,82,1251.00
2,11,HOL,825,12410.00,761,11349.50,64,1060.50
3,11,HOL,708,10651.00,644,9700.00,64,951.00
4,11,HOL,599,8739.50,546,7962.50,53,777.00
5,11,HOL,618,9092.50,569,8370.00,49,722.50
6,11,HOL,895,12628.50,838,11842.00,57,786.50
7,11,HOL,1167,16099.50,1083,14848.50,84,1251.00
8,11,HOL,1620,21855.50,1523,20492.50,97,1363.00
9,11,HOL,2066,27881.00,1952,26197.00,114,1684.00
10,11,HOL,2192,28814.00,2062,27021.50,130,1792.50
11,11,HOL,2321,32931.50,2180,30838.50,141,2093.00
12,11,HOL,2213,31111.50,2052,28806.50,161,2305.00
13,11,HOL,2156,30533.00,2002,28276.50,154,2256.50
14,11,HOL,2187,31196.50,2033,28971.50,154,2225.00
15,11,HOL,2184,31513.50,2018,29089.00,166,2424.50
16,11,HOL,2325,33813.00,2139,31056.50,186,2756.50
17,11,HOL,2341,33844.50,2161,31200.50,180,2644.00
18,11,HOL,2275,32798.00,2087,30051.00,188,2747.00
19,11,HOL,2185,31784.50,2008,29196.00,177,2588.50
20,11,HOL,1819,26638.50,1656,24238.00,163,2400.50
21,11,HOL,1439,20435.00,1320,18664.00,119,1771.00
22,11,HOL,1475,21500.00,1351,19535.00,124,1965.00
23,11,HOL,842,12347.50,762,11170.00,80,1177.50
0,12,HOL,684,10311.50,612,9099.50,72,1212.00
1,12,HOL,473,7539.00,425,6601.50,48,937.50
2,12,HOL,324,5927.00,297,5334.50,27,592.50
3,12,HOL,342,6591.00,310,5860.50,32,730.50
4,12,HOL,602,10732.00,553,9741.00,49,991.00
5,12,HOL,1963,31031.00,1824,28338.00,139,2693.00
6,12,HOL,2452,39078.50,2281,36229.00,171,2849.50
7,12,HOL,2213,35593.00,2060,32934.00,153,2659.00
8,12,HOL,1967,30487.00,1824,28025.00,143,2462.00
9,12,HOL,1835,28646.00,1699,26436.00,136,2210.00
10,12,HOL,1693,25256.00,1584,23612.00,109,1644.00
11,12,HOL,1599,23188.00,1486,21457.50,113,1730.50
12,12,HOL,1607,23421.50,1495,21625.00,112,1796.50
13,12,HOL,1546,22881.50,1431,21040.00,115,1841.50
14,12,HOL,1784,26348.50,1668,24588.50,116,1760.00
15,12,HOL,1870,27159.50,1737,25227.50,133,1932.00
16,12,HOL,2099,31404.50,1953,29158.50,146,2246.00
17,12,HOL,2347,34652.50,2196,32343.50,151,2309.00
18,12,HOL,2412,35351.50,2216,32475.00,196,2876.50
19,12,HOL,1749,25671.50,1607,23510.00,142,2161.50
20,12,HOL,1395,20236.00,1283,18548.50,112,1687.50
21,12,HOL,1237,17964.50,1134,16403.00,103,1561.50
22,12,HOL,1127,17002.50,1045,15675.00,82,1327.50
23,12,HOL,705,10554.50,662,9923.00,43,631.50
0,13,HOL,486,7535.50,447,6815.50,39,720.00
1,13,HOL,337,5823.00,310,5230.50,27,592.50
2,13,HOL,262,4975.00,245,4633.00,17,342.00
3,13,HOL,330,6596.00,311,6237.50,19,358.50
4,13,HOL,628,11283.50,593,10464.50,35,819.00
5,13,HOL,2127,33965.00,1984,31365.50,143,2599.50
6,13,HOL,2440,38819.50,2219,35056.00,221,3763.50
7,13,HOL,2430,37974.50,2231,34893.00,199,3081.50
8,13,HOL,2384,38776.50,2181,35198.50,203,3578.00
9,13,HOL,2453,38090.00,2253,34888.50,200,3201.50
10,13,HOL,2290,33301.00,2104,30371.50,186,2929.50
11,13,HOL,2208,32624.00,2022,29683.00,186,2941.00
12,13,HOL,1685,24851.50,1551,22773.50,134,2078.00
13,13,HOL,1453,21988.50,1361,20635.50,92,1353.00
14,13,HOL,1568,23685.50,1460,21787.50,108,1898.00
15,13,HOL,1886,28135.50,1756,26136.00,130,1999.50
16,13,HOL,2125,32450.00,1982,30180.50,143,2269.50
17,13,HOL,2368,35335.50,2205,32809.00,163,2526.50
18,13,HOL,2263,33206.00,2101,30669.00,162,2537.00
19,13,HOL,1626,24005.50,1482,21819.00,144,2186.50
20,13,HOL,1287,18723.00,1196,17337.00,91,1386.00
21,13,HOL,1219,17536.50,1113,16023.00,106,1513.50
22,13,HOL,1268,19147.50,1176,17606.00,92,1541.50
23,13,HOL,776,11825.50,713,10889.50,63,936.00
0,14,HOL,590,9153.50,538,8209.00,52,944.50
1,14,HOL,458,7332.00,412,6585.00,46,747.00
2,14,HOL,313,5861.00,294,5384.00,19,477.00
3,14,HOL,360,7099.50,337,6553.50,23,546.00
4,14,HOL,605,11456.00,556,10382.50,49,1073.50
5,14,HOL,2311,37040.50,2184,34846.50,127,2194.00
6,14,HOL,2520,39975.00,2343,37133.00,177,2842.00
7,14,HOL,2475,39127.50,2299,36071.00,176,3056.50
8,14,HOL,2443,39762.00,2284,37209.00,159,2553.00
9,14,HOL,2426,38124.00,2245,35233.50,181,2890.50
10,14,HOL,1900,28637.50,1754,26205.00,146,2432.50
11,14,HOL,1931,28056.00,1776,25742.50,155,2313.50
12,14,HOL,1558,23479.00,1446,21480.50,112,1998.50
13,14,HOL,1541,23244.50,1441,21613.50,100,1631.00
14,14,HOL,1563,22780.50,1454,21057.50,109,1723.00
15,14,HOL,1848,27141.00,1743,25503.50,105,1637.50
16,14,HOL,2129,31937.00,1999,30011.50,130,1925.50
17,14,HOL,2439,36613.00,2278,34096.50,161,2516.50
18,14,HOL,2167,31877.50,2009,29483.00,158,2394.50
19,14,HOL,1933,28568.00,1796,26458.50,137,2109.50
20,14,HOL,1391,19876.00,1295,18371.50,96,1504.50
21,14,HOL,1435,20668.50,1327,19044.00,108,1624.50
22,14,HOL,1389,20740.50,1291,19136.00,98,1604.50
23,14,HOL,940,14379.00,853,13056.00,87,1323.00
0,15,HOL,667,10602.00,610,9514.50,57,1087.50
1,15,HOL,504,8056.00,459,7223.50,45,832.50
2,15,HOL,341,6089.00,317,5594.00,24,495.00
3,15,HOL,379,7073.00,345,6439.00,34,634.00
4,15,HOL,590,10565.00,542,9545.50,48,1019.50
5,15,HOL,2277,36537.00,2134,34037.50,143,2499.50
6,15,HOL,2494,39664.50,2334,36989.50,160,2675.00
7,15,HOL,2457,38271.00,2305,35873.50,152,2397.50
8,15,HOL,2496,39828.50,2321,36771.00,175,3057.50
9,15,HOL,2312,36381.00,2141,33592.50,171,2788.50
10,15,HOL,1992,29972.00,1861,27884.00,131,2088.00
11,15,HOL,1485,22237.50,1374,20485.50,111,1752.00
12,15,HOL,1386,20554.00,1278,18751.00,108,1803.00
13,15,HOL,1478,22416.50,1370,20651.00,108,1765.50
14,15,HOL,1274,19416.00,1168,17323.00,106,2093.00
15,15,HOL,1233,19203.50,1118,16891.00,115,2312.50
16,15,HOL,937,15050.00,853,13398.00,84,1652.00
17,15,HOL,1013,16638.00,924,14617.00,89,2021.00
18,15,HOL,1004,17150.00,921,15143.50,83,2006.50
19,15,HOL,967,15392.00,905,13921.50,62,1470.50
20,15,HOL,922,13816.50,858,12856.50,64,960.00
21,15,HOL,1010,15140.00,931,13817.00,79,1323.00
22,15,HOL,1176,17376.50,1091,16106.00,85,1270.50
23,15,HOL,1023,15514.00,954,14416.00,69,1098.00
0,16,HOL,684,10882.00,623,9577.00,61,1305.00
1,16,HOL,596,9138.00,556,8538.00,40,600.00
2,16,HOL,508,8735.50,468,7649.50,40,1086.00
3,16,HOL,499,8562.50,472,8091.50,27,471.00
4,16,HOL,529,9028.50,498,8554.50,31,474.00
5,16,HOL,1613,26360.50,1518,24685.50,95,1675.00
6,16,HOL,2267,36112.50,2102,33284.00,165,2828.50
7,16,HOL,2102,33892.00,1951,31389.50,151,2502.50
8,16,HOL,1930,31704.50,1782,28930.50,148,2774.00
9,16,HOL,1698,28337.00,1574,26048.00,124,2289.00
10,16,HOL,1510,23638.50,1409,21722.50,101,1916.00
11,16,HOL,1526,22564.00,1405,20768.00,121,1796.00
12,16,HOL,1610,23836.50,1494,21874.00,116,1962.50
13,16,HOL,1691,25072.00,1572,23135.00,119,1937.00
14,16,HOL,1777,26519.50,1666,24723.00,111,1796.50
15,16,HOL,2213,31919.50,2055,29527.50,158,2392.00
16,16,HOL,2157,32184.00,2001,29786.50,156,2397.50
17,16,HOL,2225,32362.00,2064,30010.00,161,2352.00
18,16,HOL,2294,33276.00,2142,30962.00,152,2314.00
19,16,HOL,1873,27341.00,1721,25054.00,152,2287.00
20,16,HOL,1442,20248.00,1308,18192.50,134,2055.50
21,16,HOL,1347,19110.00,1234,17455.50,113,1654.50
22,16,HOL,1229,17619.00,1131,16101.00,98,1518.00
23,16,HOL,1141,16656.50,1038,15067.00,103,1589.50
0,17,HOL,947,14661.50,873,13302.50,74,1359.00
1,17,HOL,717,11242.00,660,10249.00,57,993.00
2,17,HOL,609,9819.50,552,8846.00,57,973.50
3,17,HOL,567,9762.50,524,8858.00,43,904.50
4,17,HOL,601,10086.00,549,9083.50,52,1002.50
5,17,HOL,948,15184.00,873,13778.00,75,1406.00
6,17,HOL,1439,21606.50,1340,20024.00,99,1582.50
7,17,HOL,1697,24971.50,1583,23130.50,114,1841.00
8,17,HOL,1904,27287.00,1786,25525.00,118,1762.00
9,17,HOL,1900,26327.50,1779,24389.00,121,1938.50
10,17,HOL,1927,26438.00,1807,24578.00,120,1860.00
11,17,HOL,2116,30313.00,1969,28055.50,147,2257.50
12,17,HOL,2225,31608.00,2060,29120.50,165,2487.50
13,17,HOL,2128,30438.50,1991,28376.50,137,2062.00
14,17,HOL,1882,26975.00,1774,25368.50,108,1606.50
15,17,HOL,2076,30102.50,1930,27887.50,146,2215.00
16,17,HOL,2090,30087.00,1943,27869.50,147,2217.50
17,17,HOL,2156,31375.50,1991,28922.00,165,2453.50
18,17,HOL,2114,31031.00,1937,28348.50,177,2682.50
19,17,HOL,2101,30636.00,1953,28522.00,148,2114.00
20,17,HOL,1626,23855.50,1502,21927.00,124,1928.50
21,17,HOL,1534,21853.50,1390,19788.00,144,2065.50
22,17,HOL,1608,22546.00,1484,20775.00,124,1771.00
23,17,HOL,1344,19301.00,1229,17591.00,115,1710.00
0,18,HOL,1071,15473.00,987,14130.50,84,1342.50
1,18,HOL,910,13436.00,835,12294.50,75,1141.50
2,18,HOL,778,11633.00,725,10856.00,53,777.00
3,18,HOL,688,10528.50,644,9882.00,44,646.50
4,18,HOL,542,8074.50,488,7233.00,54,841.50
5,18,HOL,650,9470.50,593,8568.50,57,902.00
6,18,HOL,962,13542.50,895,12553.00,67,989.50
7,18,HOL,1220,16917.50,1134,15611.50,86,1306.00
8,18,HOL,1539,21147.50,1430,19471.00,109,1676.50
9,18,HOL,1869,25106.50,1741,23312.50,128,1794.00
10,18,HOL,2066,27282.50,1939,25476.50,127,1806.00
11,18,HOL,2302,32526.00,2170,30564.50,132,1961.50
12,18,HOL,2137,30308.50,2016,28564.50,121,1744.00
13,18,HOL,2098,29739.00,1952,27624.00,146,2115.00
14,18,HOL,2028,28921.50,1881,26791.50,147,2130.00
15,18,HOL,2078,29993.00,1919,27646.50,159,2346.50
16,18,HOL,1994,28771.50,1867,26871.00,127,1900.50
17,18,HOL,2385,34667.00,2194,31828.00,191,2839.00
18,18,HOL,2205,32218.00,1993,29031.00,212,3187.00
19,18,HOL,1637,23939.00,1512,22059.00,125,1880.00
20,18,HOL,1447,21137.50,1340,19494.00,107,1643.50
21,18,HOL,1244,17760.50,1157,16407.50,87,1353.00
22,18,HOL,1166,16862.50,1078,15503.00,88,1359.50
23,18,HOL,681,10066.00,607,8902.00,74,1164.00
0,19,HOL,479,7206.50,442,6644.50,37,562.00
1,19,HOL,323,5261.00,283,4595.00,40,666.00
2,19,HOL,317,5973.00,292,5511.00,25,462.00
3,19,HOL,347,6583.50,326,6264.00,21,319.50
4,19,HOL,747,12993.00,692,11979.00,55,1014.00
5,19,HOL,2323,36298.50,2153,33371.00,170,2927.50
6,19,HOL,2327,36283.50,2157,33701.00,170,2582.50
7,19,HOL,2367,37016.50,2197,34313.50,170,2703.00
8,19,HOL,2357,37859.00,2161,34343.00,196,3516.00
9,19,HOL,2266,35684.00,2093,33021.00,173,2663.00
10,19,HOL,1897,28307.00,1767,26332.50,130,1974.50
11,19,HOL,1578,23638.00,1447,21516.00,131,2122.00
12,19,HOL,1494,22108.50,1358,19984.50,136,2124.00
13,19,HOL,1461,21408.50,1344,19676.00,117,1732.50
14,19,HOL,1560,23372.50,1453,21765.00,107,1607.50
15,19,HOL,1611,23416.50,1501,21766.50,110,1650.00
16,19,HOL,2021,30409.50,1867,28108.00,154,2301.50
17,19,HOL,2269,33563.50,2117,31310.50,152,2253.00
18,19,HOL,2052,30327.50,1922,28362.50,130,1965.00
19,19,HOL,1628,23911.00,1493,21899.50,135,2011.50
20,19,HOL,1302,19197.00,1195,17601.00,107,1596.00
21,19,HOL,1214,17919.00,1111,16158.00,103,1761.00
22,19,HOL,1177,17532.00,1081,16036.50,96,1495.50
23,19,HOL,660,10059.50,611,9324.50,49,735.00
0,20,HOL,494,7896.50,451,6998.00,43,898.50
1,20,HOL,360,6049.50,316,5274.00,44,775.50
2,20,HOL,321,5982.50,296,5472.50,25,510.00
3,20,HOL,354,7164.00,331,6666.50,23,497.50
4,20,HOL,713,12533.50,654,11524.00,59,1009.50
5,20,HOL,1767,28238.00,1659,26571.00,108,1667.00
6,20,HOL,2423,38432.50,2252,35771.50,171,2661.00
7,20,HOL,2452,39379.00,2283,36560.50,169,2818.50
8,20,HOL,2362,38142.00,2182,35243.50,180,2898.50
9,20,HOL,2176,34063.00,2006,31331.00,170,2732.00
10,20,HOL,2294,33903.00,2107,31027.50,187,2875.50
11,20,HOL,2167,32130.00,1978,29250.50,189,2879.50
12,20,HOL,1726,25848.50,1603,23798.00,123,2050.50
13,20,HOL,1913,28109.50,1768,25810.50,145,2299.00
14,20,HOL,2003,29689.00,1864,27551.00,139,2138.00
15,20,HOL,2160,31710.00,2018,29554.50,142,2155.50
16,20,HOL,2243,33357.00,2063,30689.00,180,2668.00
17,20,HOL,2305,33687.50,2105,30725.50,200,2962.00
18,20,HOL,2323,34433.00,2158,32014.50,165,2418.50
19,20,HOL,2130,31202.00,1967,28769.00,163,2433.00
20,20,HOL,1739,24840.00,1611,22866.50,128,1973.50
21,20,HOL,1387,20335.50,1290,18763.50,97,1572.00
22,20,HOL,1332,19893.50,1244,18450.50,88,1443.00
23,20,HOL,908,13590.50,827,12358.50,81,1232.00
0,21,HOL,575,9284.50,525,8312.00,50,972.50
1,21,HOL,528,8787.00,472,7700.00,56,1087.00
2,21,HOL,401,7463.00,361,6662.00,40,801.00
3,21,HOL,390,7081.50,365,6529.50,25,552.00
4,21,HOL,842,14308.50,770,12897.00,72,1411.50
5,21,HOL,2378,38116.50,2238,35614.50,140,2502.00
6,21,HOL,2347,37832.50,2174,34878.00,173,2954.50
7,21,HOL,2342,37382.50,2164,34465.50,178,2917.00
8,21,HOL,2253,36819.00,2079,33991.00,174,2828.00
9,21,HOL,1672,27576.50,1539,25279.00,133,2297.50
10,21,HOL,1448,22899.00,1334,20985.00,114,1914.00
11,21,HOL,1435,21111.50,1335,19619.50,100,1492.00
12,21,HOL,1484,21909.50,1365,19909.00,119,2000.50
13,21,HOL,1440,21414.50,1342,19709.50,98,1705.00
14,21,HOL,1835,26679.50,1724,24821.50,111,1858.00
15,21,HOL,2147,30525.00,2003,28271.50,144,2253.50
16,21,HOL,2107,31294.50,1945,28822.50,162,2472.00
17,21,HOL,2054,30288.50,1911,28029.00,143,2259.50
18,21,HOL,1864,27407.00,1714,25077.50,150,2329.50
19,21,HOL,1563,22883.00,1447,21141.50,116,1741.50
20,21,HOL,1385,19501.50,1253,17449.00,132,2052.50
21,21,HOL,1239,17245.00,1134,15736.50,105,1508.50
22,21,HOL,1381,19785.50,1259,17909.00,122,1876.50
23,21,HOL,931,13343.50,867,12317.50,64,1026.00
0,22,HOL,645,9248.50,593,8450.50,52,798.00
1,22,HOL,464,6964.00,411,6049.50,53,914.50
2,22,HOL,358,5732.50,313,4840.00,45,892.50
3,22,HOL,362,5829.50,326,5145.50,36,684.00
4,22,HOL,576,8819.50,513,7669.00,63,1150.50
5,22,HOL,855,12282.50,798,11393.00,57,889.50
6,22,HOL,1074,15985.00,998,14850.50,76,1134.50
7,22,HOL,1174,17021.00,1102,15970.00,72,1051.00
8,22,HOL,1203,17377.00,1123,16149.50,80,1227.50
9,22,HOL,1303,18563.50,1208,17178.50,95,1385.00
10,22,HOL,1656,22218.50,1567,20973.50,89,1245.00
11,22,HOL,2059,27186.50,1947,25486.00,112,1700.50
12,22,HOL,2077,27539.00,1944,25683.50,133,1855.50
13,22,HOL,1756,23351.00,1649,21831.50,107,1519.50
14,22,HOL,1704,22581.50,1571,20712.50,133,1869.00
15,22,HOL,1901,25261.50,1757,23263.50,144,1998.00
16,22,HOL,1601,22769.00,1500,21269.50,101,1499.50
17,22,HOL,1361,19455.00,1252,17865.00,109,1590.00
18,22,HOL,1303,18693.00,1201,17210.50,102,1482.50
19,22,HOL,1333,19477.50,1244,18140.00,89,1337.50
20,22,HOL,1722,24215.00,1606,22531.00,116,1684.00
21,22,HOL,2092,29598.50,1955,27615.50,137,1983.00
22,22,HOL,2156,30452.00,2013,28410.50,143,2041.50
23,22,HOL,1373,19635.00,1265,18093.50,108,1541.50
0,23,HOL,812,12181.00,737,10934.50,75,1246.50
1,23,HOL,473,7413.50,429,6570.50,44,843.00
2,23,HOL,328,5711.00,292,5025.50,36,685.50
3,23,HOL,333,6775.00,306,6263.50,27,511.50
4,23,HOL,416,7478.50,388,6886.00,28,592.50
5,23,HOL,916,14567.00,849,13298.50,67,1268.50
6,23,HOL,1228,19777.50,1143,18343.50,85,1434.00
7,23,HOL,1223,20212.00,1115,18192.00,108,2020.00
8,23,HOL,1251,19763.00,1173,18428.50,78,1334.50
9,23,HOL,1308,20147.00,1216,18554.50,92,1592.50
10,23,HOL,1425,20398.00,1337,18925.00,88,1473.00
11,23,HOL,1577,22062.50,1444,20116.50,133,1946.00
12,23,HOL,1589,22204.00,1481,20593.00,108,1611.00
13,23,HOL,1707,24245.50,1589,22420.00,118,1825.50
14,23,HOL,1779,24819.00,1648,22899.00,131,1920.00
15,23,HOL,1891,26655.50,1748,24632.00,143,2023.50
16,23,HOL,1874,28078.50,1734,25850.50,140,2228.00
17,23,HOL,1925,27886.00,1795,26012.00,130,1874.00
18,23,HOL,1623,23324.50,1523,21869.50,100,1455.00
19,23,HOL,1409,20478.00,1303,18902.00,106,1576.00
20,23,HOL,1234,17229.50,1133,15710.50,101,1519.00
21,23,HOL,1129,16134.50,1033,14576.00,96,1558.50
22,23,HOL,1131,16134.00,1036,14701.50,95,1432.50
23,23,HOL,934,13491.50,861,12285.00,73,1206.50
0,24,HOL,687,10321.50,630,9463.50,57,858.00
1,24,HOL,469,7261.00,421,6499.50,48,761.50
2,24,HOL,398,6680.50,364,6031.00,34,649.50
3,24,HOL,393,7056.00,362,6520.50,31,535.50
4,24,HOL,447,7884.00,403,6976.00,44,908.00
5,24,HOL,752,12102.00,696,10996.00,56,1106.00
6,24,HOL,894,13687.50,828,12646.00,66,1041.50
7,24,HOL,1105,15998.50,1038,14866.50,67,1132.00
8,24,HOL,1255,18003.00,1170,16584.50,85,1418.50
9,24,HOL,1538,20967.50,1437,19379.50,101,1588.00
10,24,HOL,1761,23734.00,1638,21872.00,123,1862.00
11,24,HOL,1999,28194.00,1873,26308.00,126,1886.00
12,24,HOL,2109,29665.00,1973,27679.50,136,1985.50
13,24,HOL,2163,30645.00,2038,28833.00,125,1812.00
14,24,HOL,2145,30950.00,1999,28825.50,146,2124.50
15,24,HOL,2011,28935.50,1887,27108.50,124,1827.00
16,24,HOL,2197,31594.50,2047,29355.50,150,2239.00
17,24,HOL,2285,33114.50,2111,30505.00,174,2609.50
18,24,HOL,2221,32267.50,2046,29660.50,175,2607.00
19,24,HOL,2011,29813.00,1875,27845.00,136,1968.00
20,24,HOL,1844,27190.50,1733,25397.50,111,1793.00
21,24,HOL,1555,22058.50,1435,20149.50,120,1909.00
22,24,HOL,1410,19696.00,1303,18163.00,107,1533.00
23,24,HOL,1335,19009.00,1230,17433.00,105,1576.00
0,25,HOL,978,13945.50,892,12560.50,86,1385.00
1,25,HOL,687,9808.00,629,8989.50,58,818.50
2,25,HOL,499,7548.00,452,6759.00,47,789.00
3,25,HOL,428,6547.00,399,6098.50,29,448.50
4,25,HOL,423,6244.00,379,5597.50,44,646.50
5,25,HOL,633,9174.00,596,8565.50,37,608.50
6,25,HOL,809,11457.00,762,10711.50,47,745.50
7,25,HOL,992,13654.00,917,12506.50,75,1147.50
8,25,HOL,1410,19582.00,1303,17979.50,107,1602.50
9,25,HOL,1892,25429.50,1786,23932.50,106,1497.00
10,25,HOL,2180,29094.50,2048,27288.50,132,1806.00
11,25,HOL,2259,31982.00,2126,30057.50,133,1924.50
12,25,HOL,2202,31029.00,2048,28745.50,154,2283.50
13,25,HOL,2194,31258.50,2059,29239.50,135,2019.00
14,25,HOL,2150,30562.50,1987,28194.50,163,2368.00
15,25,HOL,2199,31357.50,2024,28793.50,175,2564.00
16,25,HOL,2247,32347.00,2041,29290.50,206,3056.50
17,25,HOL,2333,33695.00,2160,31146.50,173,2548.50
18,25,HOL,2307,33366.00,2114,30521.50,193,2844.50
19,25,HOL,2098,30247.50,1924,27675.00,174,2572.50
20,25,HOL,1945,28446.50,1786,25981.50,159,2465.00
21,25,HOL,1617,22593.00,1478,20527.50,139,2065.50
22,25,HOL,1443,20396.00,1337,18746.00,106,1650.00
23,25,HOL,1002,14190.00,909,12805.00,93,1385.00
